111111111111, 111111111111, 111111111111, 111111111111, 111111111111, 111111111111, 111111111111, 111111111111, 111111111111, 111111111111, 111111111111, 111111111111, 111111111111, 111111111111, 111111111111, 111111111111, 111111111111, 111111111111, 111111111111, 111111111111, 000000000000, 000000000000, 000000000000, 000000000000, 000000000000, 000000000000, 000000000000, 000000000000, 000000000000, 000000000000, 000000000000, 000000000000, 000000000000, 000000000000, 000000000000, 000000000000, 000000000000, 000000000000, 000000000000, 000000000000, 000000000000, 000000000000, 000000000000, 000000000000, 000000000000, 000000000000, 000000000000, 000000000000, 000000000000, 000000000000, 000000000000, 000000000000, 000000000000, 000000000000, 000000000000, 000000000000, 000000000000, 000000000000, 000000000000, 000000000000, 000000000000, 000000000000, 000000000000, 111111111111, 111111111111, 111111111111, 111111111111, 111111111111, 111111111111, 111111111111, 111111111111, 111111111111, 111111111111, 111111111111, 111111111111, 111111111111, 111111111111, 111111111111, 111111111111, 111111111111, 111111111111, 111111111111, 111111111111, 111111111111, 111111111111, 111111111111, 111111111111, 111111111111, 111111111111, 111111111111, 111111111111, 111111111111, 111111111111, 111111111111, 111111111111, 111111111111, 
111111111111, 111111111111, 110111011101, 100010001000, 010101010101, 010101010101, 010101010101, 010101010101, 010101010101, 010101010101, 010101010101, 010101010101, 010101010101, 010101010101, 010101010101, 010101010101, 010101010101, 010101010101, 010101010101, 010101010101, 010101010101, 010101010101, 010101010101, 010101010101, 010101010101, 010101010101, 010101010101, 010101010101, 010101010101, 010101010101, 010101010101, 010101010101, 010101010101, 010101010101, 010101010101, 010101010101, 010101010101, 010101010101, 010101010101, 010101010101, 010101010101, 010101010101, 010101010101, 010101010101, 010101010101, 010101010101, 010101010101, 010101010101, 010101010101, 010101010101, 010101010101, 010101010101, 010101010101, 010101010101, 010101010101, 010101010101, 010101010101, 010101010101, 010101010101, 010101010101, 010101010101, 010101010101, 010101010101, 010101010101, 010101010101, 010101010101, 010101010101, 010101010101, 010101010101, 010101010101, 010101010101, 010101010101, 010101010101, 010101010101, 010101010101, 010101010101, 010101010101, 010101010101, 010101010101, 010101010101, 010101010101, 010101010101, 010101010101, 010101010101, 010101010101, 010101010101, 010101010101, 010101010101, 010101010101, 010101010101, 010101010101, 010101010101, 011101110111, 110011001100, 111111111111, 111111111111, 
111111111111, 111111111111, 011101110111, 101010101010, 110111011101, 110011001100, 110011001100, 110011001100, 110011001100, 110011001100, 110011001100, 110011001100, 110011001100, 110011001100, 110011001100, 110011001100, 110011001100, 110011001100, 110011001100, 110011001100, 110011001100, 110011001100, 110011001100, 110011001100, 110011001100, 110011001100, 110011001100, 110011001100, 110011001100, 110011001100, 110011001100, 110011001100, 110011001100, 110011001100, 110011001100, 110011001100, 110011001100, 110011001100, 110011001100, 110011001100, 110011001100, 110011001100, 110011001100, 110011001100, 110011001100, 110011001100, 110011001100, 110011001100, 110011001100, 110011001100, 110011001100, 110011001100, 110011001100, 110011001100, 110011001100, 110011001100, 110011001100, 110011001100, 110011001100, 110011001100, 110011001100, 110011001100, 110011001100, 110011001100, 110011001100, 110011001100, 110011001100, 110011001100, 110011001100, 110011001100, 110011001100, 110011001100, 110011001100, 110011001100, 110011001100, 110011001100, 110011001100, 110011001100, 110011001100, 110011001100, 110011001100, 110011001100, 110011001100, 110011001100, 110011001100, 110011001100, 110011001100, 110011001100, 110011001100, 110011001100, 110011001100, 110111011101, 101110111011, 011101110111, 110111011101, 111111111111, 
111111111111, 101110111011, 101010101010, 111111111111, 110011001100, 100001100110, 011101010101, 011101010101, 011101010101, 011101010101, 011101010101, 011101010101, 011101010101, 011101010101, 011101010101, 011101010101, 011101010101, 011101010101, 011101100101, 011101100101, 011101100101, 011101100101, 011101100101, 011101100101, 011101100101, 011101100101, 011101100101, 011101100101, 011101100101, 011101100101, 011101100101, 011101110101, 011101110101, 011101110101, 011101110101, 011101110101, 011101110101, 011101110101, 011101110101, 011101110101, 011101110101, 011101110101, 011101110101, 011101110101, 011101110101, 011101110101, 011101110101, 011001110101, 011001110101, 011001110101, 011001110101, 011001110101, 011001110101, 011001110101, 011001110101, 011001110101, 011001110101, 011001110101, 011001110101, 011001110101, 011001110101, 011001110101, 011001110101, 011001110101, 011001110101, 011001110101, 011001110101, 011001110101, 011001110101, 011001110101, 011001110101, 011001110101, 011001110101, 011001110101, 011001110101, 011001110101, 011001110101, 011001110101, 011001110101, 011001110101, 011001110101, 011001110101, 011001110101, 011001110101, 011001110101, 011001110101, 011001110101, 010101110101, 010101110101, 010101110101, 011110000111, 110011001100, 111111111111, 110011001100, 101010101010, 111111111111, 
111111111111, 101110111011, 110111011101, 110011001100, 011001000100, 101100010001, 110100100010, 110100100010, 110100100010, 110100100010, 110100110010, 110100110010, 110101000010, 110101000010, 110101010010, 110101010010, 110101010010, 110101100010, 110101100010, 110101110010, 110101110010, 110101110010, 110110000010, 110110000010, 110110010010, 110110010010, 110110100010, 110110100010, 110110100010, 110110110010, 110110110010, 110111000010, 110111000010, 110111000010, 110111010010, 110111010010, 110111010010, 110111010010, 110111010010, 110011010010, 110011010010, 110011010010, 110011010010, 110011010010, 110011010010, 110011010010, 101111010010, 101111010010, 101111010010, 101111010010, 101111010010, 101111010010, 101111010010, 101111010010, 101011010010, 101011010010, 101011010010, 101011010010, 101011010010, 101011010010, 101011010010, 100111010010, 100111010010, 100111010010, 100111010010, 100111010010, 100111010010, 100111010010, 100111010010, 100011010010, 100011010010, 100011010010, 100011010010, 100011010010, 100011010010, 100011010010, 011111010010, 011111010010, 011111010010, 011111010010, 011111010010, 011111010010, 011111010010, 011111010010, 011011010010, 011011010010, 011011010010, 011011010010, 011011010010, 011011010010, 010010110001, 010101100100, 110011001100, 110111011101, 101110111011, 111111111111, 
111111111111, 101110111011, 110111011101, 011101100110, 110000110011, 111100000000, 111100000000, 111100000000, 111100000000, 111100000000, 111100010000, 111100010000, 111100100000, 111100110000, 111100110000, 111101000000, 111101000000, 111101010000, 111101100000, 111101100000, 111101110000, 111101110000, 111110000000, 111110010000, 111110010000, 111110100000, 111110100000, 111110110000, 111111000000, 111111000000, 111111010000, 111111010000, 111111100000, 111111110000, 111111110000, 111111110000, 111111110000, 111111110000, 111111110000, 111111110000, 111011110000, 111011110000, 111011110000, 111011110000, 111011110000, 110111110000, 110111110000, 110111110000, 110111110000, 110111110000, 110011110000, 110011110000, 110011110000, 110011110000, 110011110000, 101111110000, 101111110000, 101111110000, 101111110000, 101111110000, 101111110000, 101011110000, 101011110000, 101011110000, 101011110000, 101011110000, 100111110000, 100111110000, 100111110000, 100111110000, 100111110000, 100011110000, 100011110000, 100011110000, 100011110000, 100011110000, 100011110000, 011111110000, 011111110000, 011111110000, 011111110000, 011111110000, 011011110000, 011011110000, 011011110000, 011011110000, 011011110000, 010111110000, 010111110000, 010111110000, 010111110000, 011011000011, 011110000111, 110111011101, 110011001100, 111111111111, 
111111111111, 101110111011, 110011001100, 011101010101, 111100000000, 111100000000, 111100000000, 111100000000, 111100000000, 111100000000, 111100010000, 111100010000, 111100100000, 111100110000, 111100110000, 111101000000, 111101000000, 111101010000, 111101100000, 111101100000, 111101110000, 111101110000, 111110000000, 111110010000, 111110010000, 111110100000, 111110100000, 111110110000, 111111000000, 111111000000, 111111010000, 111111010000, 111111100000, 111111110000, 111111110000, 111111110000, 111111110000, 111111110000, 111111110000, 111111110000, 111011110000, 111011110000, 111011110000, 111011110000, 111011110000, 110111110000, 110111110000, 110111110000, 110111110000, 110111110000, 110011110000, 110011110000, 110011110000, 110011110000, 110011110000, 101111110000, 101111110000, 101111110000, 101111110000, 101111110000, 101111110000, 101011110000, 101011110000, 101011110000, 101011110000, 101011110000, 100111110000, 100111110000, 100111110000, 100111110000, 100111110000, 100011110000, 100011110000, 100011110000, 100011110000, 100011110000, 100011110000, 011111110000, 011111110000, 011111110000, 011111110000, 011111110000, 011011110000, 011011110000, 011011110000, 011011110000, 011011110000, 010111110000, 010111110000, 010111110000, 010111110000, 010111100000, 011001110101, 110111011101, 110011001100, 111111111111, 
111111111111, 101110111011, 110011001100, 011101100110, 111100000000, 111100000000, 111100000000, 111100000000, 111100000000, 111100000000, 111100010000, 111100010000, 111100100000, 111100110000, 111100110000, 111101000000, 111101000000, 111101010000, 111101100000, 111101100000, 111101110000, 111101110000, 111110000000, 111110010000, 111110010000, 111110100000, 111110100000, 111110110000, 111111000000, 111111000000, 111111010000, 111111010000, 111111100000, 111111110000, 111111110000, 111111110000, 111111110000, 111111110000, 111111110000, 111111110000, 111011110000, 111011110000, 111011110000, 111011110000, 111011110000, 110111110000, 110111110000, 110111110000, 110111110000, 110111110000, 110011110000, 110011110000, 110011110000, 110011110000, 110011110000, 101111110000, 101111110000, 101111110000, 101111110000, 101111110000, 101111110000, 101011110000, 101011110000, 101011110000, 101011110000, 101011110000, 100111110000, 100111110000, 100111110000, 100111110000, 100111110000, 100011110000, 100011110000, 100011110000, 100011110000, 100011110000, 100011110000, 011111110000, 011111110000, 011111110000, 011111110000, 011111110000, 011011110000, 011011110000, 011011110000, 011011110000, 011011110000, 010111110000, 010111110000, 010111110000, 010111110000, 010111100000, 011001110110, 110011001100, 110011001100, 111111111111, 
111111111111, 101110111011, 110011001100, 011101100110, 111100000000, 111100000000, 111100000000, 111100000000, 111100000000, 111100000000, 111100010000, 111100010000, 111100100000, 111100110000, 111100110000, 111101000000, 111101000000, 111101010000, 111101100000, 111101100000, 111101110000, 111101110000, 111110000000, 111110010000, 111110010000, 111110100000, 111110100000, 111110110000, 111111000000, 111111000000, 111111010000, 111111010000, 111111100000, 111111110000, 111111110000, 111111110000, 111111110000, 111111110000, 111111110000, 111111110000, 111011110000, 111011110000, 111011110000, 111011110000, 111011110000, 110111110000, 110111110000, 110111110000, 110111110000, 110111110000, 110011110000, 110011110000, 110011110000, 110011110000, 110011110000, 101111110000, 101111110000, 101111110000, 101111110000, 101111110000, 101111110000, 101011110000, 101011110000, 101011110000, 101011110000, 101011110000, 100111110000, 100111110000, 100111110000, 100111110000, 100111110000, 100011110000, 100011110000, 100011110000, 100011110000, 100011110000, 100011110000, 011111110000, 011111110000, 011111110000, 011111110000, 011111110000, 011011110000, 011011110000, 011011110000, 011011110000, 011011110000, 010111110000, 010111110000, 010111110000, 010111110000, 010111100000, 011001110110, 110111011101, 110011001100, 111111111111, 
111111111111, 101110111011, 110011001100, 011001010101, 111000010001, 111100000000, 111100000000, 111100000000, 111100000000, 111100000000, 111100010000, 111100010000, 111100100000, 111100110000, 111100110000, 111101000000, 111101000000, 111101010000, 111101100000, 111101100000, 111101110000, 111101110000, 111110000000, 111110010000, 111110010000, 111110100000, 111110100000, 111110110000, 111111000000, 111111000000, 111111010000, 111111010000, 111111100000, 111111110000, 111111110000, 111111110000, 111111110000, 111111110000, 111111110000, 111111110000, 111011110000, 111011110000, 111011110000, 111011110000, 111011110000, 110111110000, 110111110000, 110111110000, 110111110000, 110111110000, 110011110000, 110011110000, 110011110000, 110011110000, 110011110000, 101111110000, 101111110000, 101111110000, 101111110000, 101111110000, 101111110000, 101011110000, 101011110000, 101011110000, 101011110000, 101011110000, 100111110000, 100111110000, 100111110000, 100111110000, 100111110000, 100011110000, 100011110000, 100011110000, 100011110000, 100011110000, 100011110000, 011111110000, 011111110000, 011111110000, 011111110000, 011111110000, 011011110000, 011011110000, 011011110000, 011011110000, 011011110000, 010111110000, 010111110000, 010111110000, 010111110000, 010111100001, 011001110110, 110111011101, 110011001100, 111111111111, 
111111111111, 101110111011, 110111011101, 100110011001, 100101000100, 111100000000, 111100000000, 111100000000, 111100000000, 111100000000, 111100010000, 111100010000, 111100100000, 111100110000, 111100110000, 111101000000, 111101000000, 111101010000, 111101100000, 111101100000, 111101110000, 111101110000, 111110000000, 111110010000, 111110010000, 111110100000, 111110100000, 111110110000, 111111000000, 111111000000, 111111010000, 111111010000, 111111100000, 111111110000, 111111110000, 111111110000, 111111110000, 111111110000, 111111110000, 111111110000, 111011110000, 111011110000, 111011110000, 111011110000, 111011110000, 110111110000, 110111110000, 110111110000, 110111110000, 110111110000, 110011110000, 110011110000, 110011110000, 110011110000, 110011110000, 101111110000, 101111110000, 101111110000, 101111110000, 101111110000, 101111110000, 101011110000, 101011110000, 101011110000, 101011110000, 101011110000, 100111110000, 100111110000, 100111110000, 100111110000, 100111110000, 100011110000, 100011110000, 100011110000, 100011110000, 100011110000, 100011110000, 011111110000, 011111110000, 011111110000, 011111110000, 011111110000, 011011110000, 011011110000, 011011110000, 011011110000, 011011110000, 010111110000, 010111110000, 010111110000, 010111110000, 010110010100, 100110011001, 110111011101, 110011001100, 111111111111, 
111111111111, 101110111011, 110111011101, 111111111111, 011101110111, 010100010001, 011100100010, 011100100010, 011100100010, 011100110010, 011100110010, 011100110010, 011100110010, 011100110010, 011100110010, 011101000010, 011101000010, 011101000010, 011101000010, 011101000010, 011101010010, 011101010010, 011101010010, 011101010010, 011101010010, 011101100010, 011101100010, 011101100010, 011101100010, 011101100010, 011101100010, 011101110010, 011101110010, 011101110010, 011101110010, 011101110010, 011101110010, 011101110010, 011101110010, 011101110010, 011101110010, 011101110010, 011101110010, 011101110010, 011101110010, 011101110010, 011101110010, 011101110010, 011001110010, 011001110010, 011001110010, 011001110010, 011001110010, 011001110010, 011001110010, 011001110010, 011001110010, 011001110010, 011001110010, 011001110010, 011001110010, 011001110010, 011001110010, 011001110010, 010101110010, 010101110010, 010101110010, 010101110010, 010101110010, 010101110010, 010101110010, 010101110010, 010101110010, 010101110010, 010101110010, 010101110010, 010101110010, 010101110010, 010101110010, 010101110010, 010101110010, 010101110010, 010001110010, 010001110010, 010001110010, 010001110010, 010001110010, 010001110010, 010001110010, 010001110010, 001001010001, 100010000111, 111111111111, 110111011101, 101110111011, 111111111111, 
111111111111, 110011001100, 101010101010, 111111111111, 111111111111, 110111011101, 101110111011, 101110111011, 101110111011, 101110111011, 101110111011, 101110111011, 101110111011, 101110111011, 101110111011, 101110111011, 101110111011, 101110111011, 101110111011, 101110111011, 101110111011, 101110111011, 101110111011, 101110111011, 101110111011, 101110111011, 101110111011, 101110111011, 101110111011, 101110111011, 101110111011, 101110111011, 101110111011, 101110111011, 101110111011, 101110111011, 101110111011, 101110111011, 101110111011, 101110111011, 101110111011, 101110111011, 101110111011, 101110111011, 101110111011, 101110111011, 101110111011, 101110111011, 101110111011, 101110111011, 101110111011, 101110111011, 101110111011, 101110111011, 101110111011, 101110111011, 101110111011, 101110111011, 101110111011, 101110111011, 101110111011, 101110111011, 101110111011, 101110111011, 101110111011, 101110111011, 101110111011, 101110111011, 101110111011, 101110111011, 101110111011, 101110111011, 101110111011, 101110111011, 101110111011, 101110111011, 101110111011, 101110111011, 101110111011, 101110111011, 101110111011, 101110111011, 101110111011, 101110111011, 101110111011, 101110111011, 101110111011, 101110111011, 101110111011, 101110111011, 110111011101, 111111111111, 111111111111, 110011001100, 101010101010, 111111111111, 
111111111111, 111111111111, 011001100110, 100110011001, 110111011101, 110111011101, 110111011101, 110111011101, 110111011101, 110111011101, 110111011101, 110111011101, 110111011101, 110111011101, 110111011101, 110111011101, 110111011101, 110111011101, 110111011101, 110111011101, 110111011101, 110111011101, 110111011101, 110111011101, 110111011101, 110111011101, 110111011101, 110111011101, 110111011101, 110111011101, 110111011101, 110111011101, 110111011101, 110111011101, 110111011101, 110111011101, 110111011101, 110111011101, 110111011101, 110111011101, 110111011101, 110111011101, 110111011101, 110111011101, 110111011101, 110111011101, 110111011101, 110111011101, 110111011101, 110111011101, 110111011101, 110111011101, 110111011101, 110111011101, 110111011101, 110111011101, 110111011101, 110111011101, 110111011101, 110111011101, 110111011101, 110111011101, 110111011101, 110111011101, 110111011101, 110111011101, 110111011101, 110111011101, 110111011101, 110111011101, 110111011101, 110111011101, 110111011101, 110111011101, 110111011101, 110111011101, 110111011101, 110111011101, 110111011101, 110111011101, 110111011101, 110111011101, 110111011101, 110111011101, 110111011101, 110111011101, 110111011101, 110111011101, 110111011101, 110111011101, 110111011101, 110111011101, 101010101010, 011001100110, 110111011101, 111111111111, 
111111111111, 111111111111, 111111111111, 100010001000, 010101010101, 010101010101, 010101010101, 010101010101, 010101010101, 010101010101, 010101010101, 010101010101, 010101010101, 010101010101, 010101010101, 010101010101, 010101010101, 010101010101, 010101010101, 010101010101, 010101010101, 010101010101, 010101010101, 010101010101, 010101010101, 010101010101, 010101010101, 010101010101, 010101010101, 010101010101, 010101010101, 010101010101, 010101010101, 010101010101, 010101010101, 010101010101, 010101010101, 010101010101, 010101010101, 010101010101, 010101010101, 010101010101, 010101010101, 010101010101, 010101010101, 010101010101, 010101010101, 010101010101, 010101010101, 010101010101, 010101010101, 010101010101, 010101010101, 010101010101, 010101010101, 010101010101, 010101010101, 010101010101, 010101010101, 010101010101, 010101010101, 010101010101, 010101010101, 010101010101, 010101010101, 010101010101, 010101010101, 010101010101, 010101010101, 010101010101, 010101010101, 010101010101, 010101010101, 010101010101, 010101010101, 010101010101, 010101010101, 010101010101, 010101010101, 010101010101, 010101010101, 010101010101, 010101010101, 010101010101, 010101010101, 010101010101, 010101010101, 010101010101, 010101010101, 010101010101, 010101010101, 010101010101, 011101110111, 110011001100, 111111111111, 111111111111, 
111111111111, 111111111111, 111111111111, 111111111111, 111111111111, 111111111111, 111111111111, 111111111111, 111111111111, 111111111111, 111111111111, 111111111111, 111111111111, 111111111111, 111111111111, 111111111111, 111111111111, 111111111111, 111111111111, 111111111111, 111111111111, 111111111111, 111111111111, 111111111111, 111111111111, 111111111111, 111111111111, 111111111111, 111111111111, 111111111111, 111111111111, 111111111111, 111111111111, 111111111111, 111111111111, 111111111111, 111111111111, 111111111111, 111111111111, 111111111111, 111111111111, 111111111111, 111111111111, 111111111111, 111111111111, 111111111111, 111111111111, 111111111111, 111111111111, 111111111111, 111111111111, 111111111111, 111111111111, 111111111111, 111111111111, 111111111111, 111111111111, 111111111111, 111111111111, 111111111111, 111111111111, 111111111111, 111111111111, 111111111111, 111111111111, 111111111111, 111111111111, 111111111111, 111111111111, 111111111111, 111111111111, 111111111111, 111111111111, 111111111111, 111111111111, 111111111111, 111111111111, 111111111111, 111111111111, 111111111111, 111111111111, 111111111111, 111111111111, 111111111111, 111111111111, 111111111111, 111111111111, 111111111111, 111111111111, 111111111111, 111111111111, 111111111111, 111111111111, 111111111111, 111111111111, 111111111111;
