111111111111, 111111111111, 111111111111, 111111111111, 111111111111, 111111111111, 111111111111, 111111111111, 111111111111, 111111111111, 111111111111, 111111111111, 111111111111, 111111111111, 111111111111, 111111111111, 111111111111, 111111111111, 111111111111, 111111111111, 000000000000, 000000000000, 000000000000, 000000000000, 000000000000, 000000000000, 000000000000, 000000000000, 000000000000, 000000000000, 000000000000, 000000000000, 000000000000, 000000000000, 000000000000, 000000000000, 000000000000, 000000000000, 000000000000, 000000000000, 000000000000, 000000000000, 000000000000, 000000000000, 000000000000, 000000000000, 000000000000, 000000000000, 000000000000, 000000000000, 000000000000, 000000000000, 000000000000, 000000000000, 000000000000, 000000000000, 000000000000, 000000000000, 000000000000, 000000000000, 000000000000, 000000000000, 000000000000, 111111111111, 111111111111, 111111111111, 111111111111, 111111111111, 111111111111, 111111111111, 111111111111, 111111111111, 111111111111, 111111111111, 111111111111, 111111111111, 111111111111, 111111111111, 111111111111, 111111111111, 111111111111, 111111111111, 111111111111, 111111111111, 111111111111, 111111111111, 111111111111, 111111111111, 111111111111, 111111111111, 111111111111, 111111111111, 111111111111, 111111111111, 111111111111, 111111111111, 
111111111111, 111111111111, 101110111011, 011101110111, 011001100110, 011001100110, 011001100110, 011001100110, 011001100110, 011001100110, 011001100110, 011001100110, 011001100110, 011001100110, 011001100110, 011001100110, 011001100110, 011001100110, 011001100110, 011001100110, 011001100110, 011001100110, 011001100110, 011001100110, 011001100110, 011001100110, 011001100110, 011001100110, 011001100110, 011001100110, 011001100110, 011001100110, 011001100110, 011001100110, 011001100110, 011001100110, 011001100110, 011001100110, 011001100110, 011001100110, 011001100110, 011001100110, 011001100110, 011001100110, 011001100110, 011001100110, 011001100110, 011001100110, 011001100110, 011001100110, 011001100110, 011001100110, 011001100110, 011001100110, 011001100110, 011001100110, 011001100110, 011001100110, 011001100110, 011001100110, 011001100110, 011001100110, 011001100110, 011001100110, 011001100110, 011001100110, 011001100110, 011001100110, 011001100110, 011001100110, 011001100110, 011001100110, 011001100110, 011001100110, 011001100110, 011001100110, 011001100110, 011001100110, 011001100110, 011001100110, 011001100110, 011001100110, 011001100110, 011001100110, 011001100110, 011001100110, 011001100110, 011001100110, 011001100110, 011001100110, 011001100110, 011001100110, 011101110111, 101110111011, 111111111111, 111111111111, 
111111111111, 110111011101, 011001100110, 110011001100, 110111011101, 110011001100, 101110111011, 101110111011, 101110111011, 101110111011, 101110111011, 101110111011, 101110111011, 101110111011, 101110111011, 101110111011, 101110111011, 101110111011, 101110111011, 101110111011, 101110111011, 101110111011, 101110111011, 101110111011, 101110111011, 101110111011, 101110111011, 101110111011, 101110111011, 101110111011, 101110111011, 101110111011, 101110111011, 101110111011, 101110111011, 101110111011, 101110111011, 101110111011, 101110111011, 101110111011, 101110111011, 101110111011, 101110111011, 101110111011, 101110111011, 101110111011, 101110111011, 101110111011, 101110111011, 101110111011, 101110111011, 101110111011, 101110111011, 101110111011, 101110111011, 101110111011, 101110111011, 101110111011, 101110111011, 101110111011, 101110111011, 101110111011, 101110111011, 101110111011, 101110111011, 101110111011, 101110111011, 101110111011, 101110111011, 101110111011, 101110111011, 101110111011, 101110111011, 101110111011, 101110111011, 101110111011, 101110111011, 101110111011, 101110111011, 101110111011, 101110111011, 101110111011, 101110111011, 101110111011, 101110111011, 101110111011, 101110111011, 101110111011, 101110111011, 101110111011, 110011001100, 110111011101, 101110111011, 100010001000, 110111011101, 111111111111, 
111111111111, 011101110111, 110011001100, 111111111111, 101010011001, 100001100110, 011101010101, 011101010101, 011101010101, 011101010101, 011101010101, 011101010101, 011101010101, 011101010101, 011101010101, 011101010101, 011101010101, 011101100101, 011101100101, 011101100101, 011101100101, 011101100101, 011101100101, 011101100101, 011101100101, 011101100101, 011101110101, 011101110101, 011101110101, 011101110101, 011101110101, 011101110101, 011101110101, 011101110101, 011101110101, 011101110101, 011101110101, 011101110101, 011101110101, 011101110101, 011101110101, 011101110101, 011101110101, 011101110101, 011101110101, 011101110101, 011101110101, 011101110101, 011101110101, 011101110101, 011101110101, 011101110101, 011101110101, 011101110101, 011101110101, 011101110101, 011101110101, 011101110101, 011101110101, 011101110101, 011101110101, 011101110101, 011101110101, 011001110101, 011001110101, 011001110101, 011101110110, 011101110111, 011101110111, 011101110111, 011101110111, 011101110111, 011101110111, 011101110111, 011101110111, 011101110111, 011101110111, 011101110111, 011101110111, 011101110111, 011101110111, 011101110111, 011101110111, 011101110111, 011101110111, 011101110111, 011101110111, 011101110111, 011101110111, 011101110111, 100010001000, 101110111011, 111111111111, 110011001100, 101110111011, 111111111111, 
111111111111, 011001100110, 111111111111, 101010011001, 100000110011, 110000010001, 110100100010, 110100100010, 110100100010, 110100100010, 110100110010, 110100110010, 110100110010, 110101000010, 110101000010, 110101010010, 110101010010, 110101100010, 110101100010, 110101110010, 110101110010, 110110000010, 110110000010, 110110000010, 110110010010, 110110010010, 110110100010, 110110100010, 110110110010, 110110110010, 110111000010, 110111000010, 110111000010, 110111010010, 110111010010, 110111010010, 110111010010, 110111010010, 110111010010, 110111010010, 110111010010, 110011010010, 110011010010, 110011010010, 110011010010, 110011010010, 110011010010, 110011010010, 101111010010, 101111010010, 101111010010, 101111010010, 101111010010, 101111010010, 101111010010, 101011010010, 101011010010, 101011010010, 101011010010, 101011010010, 101011010010, 101011010010, 100111010010, 100111010010, 100111010010, 100111010011, 101010111000, 101010111010, 101010111010, 101010111010, 101010111010, 101010111010, 101010111010, 101010111010, 101010111010, 101010111010, 101010111010, 101010111010, 101010111010, 101010111010, 101010111010, 101010111010, 101010111010, 101010111010, 101010111010, 101010111010, 101010111010, 101010111010, 101010111010, 101010111010, 100010011000, 010101110101, 110011001100, 110111011101, 101110111011, 111111111111, 
111111111111, 011001100110, 111111111111, 011001000100, 111000100010, 111100000000, 111100000000, 111100000000, 111100000000, 111100000000, 111100010000, 111100100000, 111100100000, 111100110000, 111100110000, 111101000000, 111101010000, 111101010000, 111101100000, 111101100000, 111101110000, 111110000000, 111110000000, 111110010000, 111110010000, 111110100000, 111110110000, 111110110000, 111111000000, 111111000000, 111111010000, 111111100000, 111111100000, 111111110000, 111111110000, 111111110000, 111111110000, 111111110000, 111111110000, 111011110000, 111011110000, 111011110000, 111011110000, 111011110000, 111011110000, 110111110000, 110111110000, 110111110000, 110111110000, 110111110000, 110011110000, 110011110000, 110011110000, 110011110000, 110011110000, 101111110000, 101111110000, 101111110000, 101111110000, 101111110000, 101111110000, 101011110000, 101011110000, 101011110000, 101011110000, 101011110010, 101111011000, 110011001100, 110011001100, 110011001100, 110011001100, 110011001100, 110011001100, 110011001100, 110011001100, 110011001100, 110011001100, 110011001100, 110011001100, 110011001100, 110011001100, 110011001100, 110011001100, 110011001100, 110011001100, 110011001100, 110011001100, 110011001100, 110011001100, 110011001100, 101111001011, 011011000011, 011110000111, 110111011101, 110011001100, 111111111111, 
111111111111, 011001100110, 110111011101, 011100110011, 111100000000, 111100000000, 111100000000, 111100000000, 111100000000, 111100000000, 111100010000, 111100100000, 111100100000, 111100110000, 111100110000, 111101000000, 111101010000, 111101010000, 111101100000, 111101100000, 111101110000, 111110000000, 111110000000, 111110010000, 111110010000, 111110100000, 111110110000, 111110110000, 111111000000, 111111000000, 111111010000, 111111100000, 111111100000, 111111110000, 111111110000, 111111110000, 111111110000, 111111110000, 111111110000, 111011110000, 111011110000, 111011110000, 111011110000, 111011110000, 111011110000, 110111110000, 110111110000, 110111110000, 110111110000, 110111110000, 110011110000, 110011110000, 110011110000, 110011110000, 110011110000, 101111110000, 101111110000, 101111110000, 101111110000, 101111110000, 101111110000, 101011110000, 101011110000, 101011110000, 101011110000, 101011110010, 101111011000, 110011001100, 110011001100, 110011001100, 110011001100, 110011001100, 110011001100, 110011001100, 110011001100, 110011001100, 110011001100, 110011001100, 110011001100, 110011001100, 110011001100, 110011001100, 110011001100, 110011001100, 110011001100, 110011001100, 110011001100, 110011001100, 110011001100, 110011001100, 101111001011, 010111100000, 011001110110, 110111011101, 110011001100, 111111111111, 
111111111111, 011001100110, 110111011101, 011101000100, 111100000000, 111100000000, 111100000000, 111100000000, 111100000000, 111100000000, 111100010000, 111100100000, 111100100000, 111100110000, 111100110000, 111101000000, 111101010000, 111101010000, 111101100000, 111101100000, 111101110000, 111110000000, 111110000000, 111110010000, 111110010000, 111110100000, 111110110000, 111110110000, 111111000000, 111111000000, 111111010000, 111111100000, 111111100000, 111111110000, 111111110000, 111111110000, 111111110000, 111111110000, 111111110000, 111011110000, 111011110000, 111011110000, 111011110000, 111011110000, 111011110000, 110111110000, 110111110000, 110111110000, 110111110000, 110111110000, 110011110000, 110011110000, 110011110000, 110011110000, 110011110000, 101111110000, 101111110000, 101111110000, 101111110000, 101111110000, 101111110000, 101011110000, 101011110000, 101011110000, 101011110000, 101011110010, 101111011000, 110011001100, 110011001100, 110011001100, 110011001100, 110011001100, 110011001100, 110011001100, 110011001100, 110011001100, 110011001100, 110011001100, 110011001100, 110011001100, 110011001100, 110011001100, 110011001100, 110011001100, 110011001100, 110011001100, 110011001100, 110011001100, 110011001100, 110011001100, 101111001011, 010111100000, 011110000110, 110011001100, 110011001100, 111111111111, 
111111111111, 011001100110, 110111011101, 011100110011, 111100000000, 111100000000, 111100000000, 111100000000, 111100000000, 111100000000, 111100010000, 111100100000, 111100100000, 111100110000, 111100110000, 111101000000, 111101010000, 111101010000, 111101100000, 111101100000, 111101110000, 111110000000, 111110000000, 111110010000, 111110010000, 111110100000, 111110110000, 111110110000, 111111000000, 111111000000, 111111010000, 111111100000, 111111100000, 111111110000, 111111110000, 111111110000, 111111110000, 111111110000, 111111110000, 111011110000, 111011110000, 111011110000, 111011110000, 111011110000, 111011110000, 110111110000, 110111110000, 110111110000, 110111110000, 110111110000, 110011110000, 110011110000, 110011110000, 110011110000, 110011110000, 101111110000, 101111110000, 101111110000, 101111110000, 101111110000, 101111110000, 101011110000, 101011110000, 101011110000, 101011110000, 101011110010, 101111011000, 110011001100, 110011001100, 110011001100, 110011001100, 110011001100, 110011001100, 110011001100, 110011001100, 110011001100, 110011001100, 110011001100, 110011001100, 110011001100, 110011001100, 110011001100, 110011001100, 110011001100, 110011001100, 110011001100, 110011001100, 110011001100, 110011001100, 110011001100, 101111001011, 010111100000, 011010000110, 110011001100, 110011001100, 111111111111, 
111111111111, 011001100110, 111111111111, 011000110011, 111100010001, 111100000000, 111100000000, 111100000000, 111100000000, 111100000000, 111100010000, 111100100000, 111100100000, 111100110000, 111100110000, 111101000000, 111101010000, 111101010000, 111101100000, 111101100000, 111101110000, 111110000000, 111110000000, 111110010000, 111110010000, 111110100000, 111110110000, 111110110000, 111111000000, 111111000000, 111111010000, 111111100000, 111111100000, 111111110000, 111111110000, 111111110000, 111111110000, 111111110000, 111111110000, 111011110000, 111011110000, 111011110000, 111011110000, 111011110000, 111011110000, 110111110000, 110111110000, 110111110000, 110111110000, 110111110000, 110011110000, 110011110000, 110011110000, 110011110000, 110011110000, 101111110000, 101111110000, 101111110000, 101111110000, 101111110000, 101111110000, 101011110000, 101011110000, 101011110000, 101011110000, 101011110010, 101111011000, 110011001100, 110011001100, 110011001100, 110011001100, 110011001100, 110011001100, 110011001100, 110011001100, 110011001100, 110011001100, 110011001100, 110011001100, 110011001100, 110011001100, 110011001100, 110011001100, 110011001100, 110011001100, 110011001100, 110011001100, 110011001100, 110011001100, 110011001100, 101111001011, 010111010001, 011001110110, 110111011101, 110011001100, 111111111111, 
111111111111, 011001100110, 111111111111, 100001110111, 101001000100, 111100000000, 111100000000, 111100000000, 111100000000, 111100000000, 111100010000, 111100100000, 111100100000, 111100110000, 111100110000, 111101000000, 111101010000, 111101010000, 111101100000, 111101100000, 111101110000, 111110000000, 111110000000, 111110010000, 111110010000, 111110100000, 111110110000, 111110110000, 111111000000, 111111000000, 111111010000, 111111100000, 111111100000, 111111110000, 111111110000, 111111110000, 111111110000, 111111110000, 111111110000, 111011110000, 111011110000, 111011110000, 111011110000, 111011110000, 111011110000, 110111110000, 110111110000, 110111110000, 110111110000, 110111110000, 110011110000, 110011110000, 110011110000, 110011110000, 110011110000, 101111110000, 101111110000, 101111110000, 101111110000, 101111110000, 101111110000, 101011110000, 101011110000, 101011110000, 101011110000, 101011110010, 101111011000, 110011001100, 110011001100, 110011001100, 110011001100, 110011001100, 110011001100, 110011001100, 110011001100, 110011001100, 110011001100, 110011001100, 110011001100, 110011001100, 110011001100, 110011001100, 110011001100, 110011001100, 110011001100, 110011001100, 110011001100, 110011001100, 110011001100, 110011001100, 101110111011, 011010000100, 101010101010, 110111011101, 110011001100, 111111111111, 
111111111111, 011001100110, 111111111111, 110111011101, 011001010101, 010100010001, 011000110011, 011100110011, 011100110011, 011100110011, 011100110011, 011100110011, 011100110011, 011100110011, 011101000011, 011101000011, 011101000011, 011101000011, 011101000011, 011101000011, 011101000011, 011101010011, 011101010011, 011101010011, 011101010011, 011101010011, 011101010011, 011101010011, 011101100011, 011101100011, 011101100011, 011101100011, 011101100011, 011101100011, 011101100011, 011001110011, 011001110011, 011001110011, 011001110011, 011001110011, 011001110011, 011001110011, 011001110011, 011001110011, 011001110011, 011001110011, 011001110011, 011001110011, 011001110011, 011001110011, 011001110011, 011001110011, 011001110011, 011001110011, 011001110011, 011001110011, 010101110011, 010101110011, 010101110011, 010101110011, 010101110011, 010101110011, 010101110011, 010101110011, 010101110011, 010101100011, 010101100100, 010101100100, 010101100100, 010101100100, 010101100100, 010101100100, 010101100100, 010101100100, 010101100100, 010101100100, 010101100100, 010101100100, 010101100100, 010101100100, 010101100100, 010101100100, 010101100100, 010101100100, 010101100100, 010101100100, 010101100100, 010101100100, 010101100100, 010101100100, 001101000011, 100010001000, 111111111111, 110111011101, 101110111011, 111111111111, 
111111111111, 100010001000, 101110111011, 111111111111, 111111111111, 110111011101, 110011001100, 110011001100, 110011001100, 110011001100, 110011001100, 110011001100, 110011001100, 110011001100, 110011001100, 110011001100, 110011001100, 110011001100, 110011001100, 110011001100, 110011001100, 110011001100, 110011001100, 110011001100, 110011001100, 110011001100, 110011001100, 110011001100, 110011001100, 110011001100, 110011001100, 110011001100, 110011001100, 110011001100, 110011001100, 110011001100, 110011001100, 110011001100, 110011001100, 110011001100, 110011001100, 110011001100, 110011001100, 110011001100, 110011001100, 110011001100, 110011001100, 110011001100, 110011001100, 110011001100, 110011001100, 110011001100, 110011001100, 110011001100, 110011001100, 110011001100, 110011001100, 110011001100, 110011001100, 110011001100, 110011001100, 110011001100, 110011001100, 110011001100, 110011001100, 110011001100, 110011001100, 110011001100, 110011001100, 110011001100, 110011001100, 110011001100, 110011001100, 110011001100, 110011001100, 110011001100, 110011001100, 110011001100, 110011001100, 110011001100, 110011001100, 110011001100, 110011001100, 110011001100, 110011001100, 110011001100, 110011001100, 110011001100, 110011001100, 110011001100, 111111111111, 111111111111, 111111111111, 101110111011, 101110111011, 111111111111, 
111111111111, 111111111111, 010001000100, 101010101010, 110111011101, 110111011101, 110111011101, 110111011101, 110111011101, 110111011101, 110111011101, 110111011101, 110111011101, 110111011101, 110111011101, 110111011101, 110111011101, 110111011101, 110111011101, 110111011101, 110111011101, 110111011101, 110111011101, 110111011101, 110111011101, 110111011101, 110111011101, 110111011101, 110111011101, 110111011101, 110111011101, 110111011101, 110111011101, 110111011101, 110111011101, 110111011101, 110111011101, 110111011101, 110111011101, 110111011101, 110111011101, 110111011101, 110111011101, 110111011101, 110111011101, 110111011101, 110111011101, 110111011101, 110111011101, 110111011101, 110111011101, 110111011101, 110111011101, 110111011101, 110111011101, 110111011101, 110111011101, 110111011101, 110111011101, 110111011101, 110111011101, 110111011101, 110111011101, 110111011101, 110111011101, 110111011101, 110111011101, 110111011101, 110111011101, 110111011101, 110111011101, 110111011101, 110111011101, 110111011101, 110111011101, 110111011101, 110111011101, 110111011101, 110111011101, 110111011101, 110111011101, 110111011101, 110111011101, 110111011101, 110111011101, 110111011101, 110111011101, 110111011101, 110111011101, 110111011101, 110111011101, 110111011101, 101010101010, 011001100110, 111111111111, 111111111111, 
111111111111, 111111111111, 111111111111, 100010001000, 011001100110, 011001100110, 011001100110, 011001100110, 011001100110, 011001100110, 011001100110, 011001100110, 011001100110, 011001100110, 011001100110, 011001100110, 011001100110, 011001100110, 011001100110, 011001100110, 011001100110, 011001100110, 011001100110, 011001100110, 011001100110, 011001100110, 011001100110, 011001100110, 011001100110, 011001100110, 011001100110, 011001100110, 011001100110, 011001100110, 011001100110, 011001100110, 011001100110, 011001100110, 011001100110, 011001100110, 011001100110, 011001100110, 011001100110, 011001100110, 011001100110, 011001100110, 011001100110, 011001100110, 011001100110, 011001100110, 011001100110, 011001100110, 011001100110, 011001100110, 011001100110, 011001100110, 011001100110, 011001100110, 011001100110, 011001100110, 011001100110, 011001100110, 011001100110, 011001100110, 011001100110, 011001100110, 011001100110, 011001100110, 011001100110, 011001100110, 011001100110, 011001100110, 011001100110, 011001100110, 011001100110, 011001100110, 011001100110, 011001100110, 011001100110, 011001100110, 011001100110, 011001100110, 011001100110, 011001100110, 011001100110, 011001100110, 011001100110, 011001100110, 011001100110, 011001100110, 011001100110, 011001100110, 100010001000, 110111011101, 111111111111, 111111111111, 
111111111111, 111111111111, 111111111111, 111111111111, 111111111111, 111111111111, 111111111111, 111111111111, 111111111111, 111111111111, 111111111111, 111111111111, 111111111111, 111111111111, 111111111111, 111111111111, 111111111111, 111111111111, 111111111111, 111111111111, 111111111111, 111111111111, 111111111111, 111111111111, 111111111111, 111111111111, 111111111111, 111111111111, 111111111111, 111111111111, 111111111111, 111111111111, 111111111111, 111111111111, 111111111111, 111111111111, 111111111111, 111111111111, 111111111111, 111111111111, 111111111111, 111111111111, 111111111111, 111111111111, 111111111111, 111111111111, 111111111111, 111111111111, 111111111111, 111111111111, 111111111111, 111111111111, 111111111111, 111111111111, 111111111111, 111111111111, 111111111111, 111111111111, 111111111111, 111111111111, 111111111111, 111111111111, 111111111111, 111111111111, 111111111111, 111111111111, 111111111111, 111111111111, 111111111111, 111111111111, 111111111111, 111111111111, 111111111111, 111111111111, 111111111111, 111111111111, 111111111111, 111111111111, 111111111111, 111111111111, 111111111111, 111111111111, 111111111111, 111111111111, 111111111111, 111111111111, 111111111111, 111111111111, 111111111111, 111111111111, 111111111111, 111111111111, 111111111111, 111111111111, 111111111111, 111111111111;
