111111111111, 111111111111, 111111111111, 111111111111, 111111111111, 111111111111, 111111111111, 111111111111, 111111111111, 111111111111, 111111111111, 111111111111, 111111111111, 111111111111, 111111111111, 111111111111, 111111111111, 111111111111, 111111111111, 111111111111, 000000000000, 000000000000, 000000000000, 000000000000, 000000000000, 000000000000, 000000000000, 000000000000, 000000000000, 000000000000, 000000000000, 000000000000, 000000000000, 000000000000, 000000000000, 000000000000, 000000000000, 000000000000, 000000000000, 000000000000, 000000000000, 000000000000, 000000000000, 000000000000, 000000000000, 000000000000, 000000000000, 000000000000, 000000000000, 000000000000, 000000000000, 000000000000, 000000000000, 000000000000, 000000000000, 000000000000, 000000000000, 000000000000, 000000000000, 000000000000, 000000000000, 000000000000, 000000000000, 111111111111, 111111111111, 111111111111, 111111111111, 111111111111, 111111111111, 111111111111, 111111111111, 111111111111, 111111111111, 111111111111, 111111111111, 111111111111, 111111111111, 111111111111, 111111111111, 111111111111, 111111111111, 111111111111, 111111111111, 111111111111, 111111111111, 111111111111, 111111111111, 111111111111, 111111111111, 111111111111, 111111111111, 111111111111, 111111111111, 111111111111, 111111111111, 111111111111, 
111111111111, 111111111111, 111111111111, 101010101010, 100010001000, 100010001000, 100010001000, 100010001000, 100010001000, 100010001000, 100010001000, 100010001000, 100010001000, 100010001000, 100010001000, 100010001000, 100010001000, 100010001000, 100010001000, 100010001000, 100010001000, 100010001000, 100010001000, 100010001000, 100010001000, 100010001000, 100010001000, 100010001000, 100010001000, 100010001000, 100010001000, 100010001000, 100010001000, 100010001000, 100010001000, 100010001000, 100010001000, 100010001000, 100010001000, 100010001000, 100010001000, 100010001000, 100010001000, 100010001000, 100010001000, 100010001000, 100010001000, 100010001000, 100010001000, 100010001000, 100010001000, 100010001000, 100010001000, 100010001000, 100010001000, 100010001000, 100010001000, 100010001000, 100010001000, 100010001000, 100010001000, 100010001000, 100010001000, 100010001000, 100010001000, 100010001000, 100010001000, 100010001000, 100010001000, 100010001000, 100010001000, 100010001000, 100010001000, 100010001000, 100010001000, 100010001000, 100010001000, 100010001000, 100010001000, 100010001000, 100010001000, 100010001000, 100010001000, 100010001000, 100010001000, 100010001000, 100010001000, 100010001000, 100010001000, 100010001000, 100010001000, 100010001000, 100110011001, 110111011101, 111111111111, 111111111111, 
111111111111, 111111111111, 010101010101, 101010101010, 110011001100, 110011001100, 110011001100, 110011001100, 110011001100, 110011001100, 110011001100, 110011001100, 110011001100, 110011001100, 110011001100, 110011001100, 110011001100, 110011001100, 110011001100, 110011001100, 110011001100, 110011001100, 110011001100, 110011001100, 110011001100, 110011001100, 110011001100, 110011001100, 110011001100, 110011001100, 110011001100, 110011001100, 110011001100, 110011001100, 110011001100, 110011001100, 110011001100, 110011001100, 110011001100, 110011001100, 110011001100, 110011001100, 110011001100, 110011001100, 110011001100, 110011001100, 110011001100, 110011001100, 110011001100, 110011001100, 110011001100, 110011001100, 110011001100, 110011001100, 110011001100, 110011001100, 110011001100, 110011001100, 110011001100, 110011001100, 110011001100, 110011001100, 110011001100, 110011001100, 110011001100, 110011001100, 110011001100, 110011001100, 110011001100, 110011001100, 110011001100, 110011001100, 110011001100, 110011001100, 110011001100, 110011001100, 110011001100, 110011001100, 110011001100, 110011001100, 110011001100, 110011001100, 110011001100, 110011001100, 110011001100, 110011001100, 110011001100, 110011001100, 110011001100, 110011001100, 110011001100, 110011001100, 101110111011, 010101010101, 110011001100, 111111111111, 
111111111111, 100010001000, 101010101010, 111111111111, 110111011101, 100010001000, 011001100110, 011001100110, 011001100110, 011001100110, 011001100110, 011001100110, 011001100110, 011001100110, 011001100110, 011001100110, 011001100110, 011001100110, 011001100110, 011001100110, 011001100110, 011001100110, 011001100110, 011001100110, 011001100110, 011001100110, 011001100110, 011001100110, 011001100110, 011001100110, 011001100110, 011001100110, 011001100110, 011001100110, 011001100110, 011001100110, 011001100110, 011001100110, 011001100110, 011001100110, 011001100110, 011001100110, 011001100110, 011001100110, 011001100110, 011001100110, 011001100110, 011001100110, 011001100110, 011001100110, 011001100110, 011001100110, 011001100110, 011001100110, 011001100110, 011001100110, 011001100110, 011001100110, 011001100110, 011001100110, 011001100110, 011001100110, 011001100110, 011001100110, 011001100110, 011001100110, 011001100110, 011001100110, 011001100110, 011001100110, 011001100110, 011001100110, 011001100110, 011001100110, 011001100110, 011001100110, 011001100110, 011001100110, 011001100110, 011001100110, 011001100110, 011001100110, 011001100110, 011001100110, 011001100110, 011001100110, 011001100110, 011001100110, 011001100110, 011001100110, 100010001000, 110111011101, 111111111111, 110111011101, 011101110111, 111111111111, 
111111111111, 011001100110, 111111111111, 110011001100, 010000110011, 101000100010, 110000110011, 110000110011, 110000110011, 110000110011, 110001000011, 110001000011, 110001000011, 110001010011, 110001010011, 110001010011, 110001100011, 110001100011, 110001100011, 110001110011, 110001110011, 110001110011, 110010000011, 110010000011, 110010010011, 110010010011, 110010010011, 110010100011, 101110100101, 101010101000, 101010101001, 101010101001, 101010101001, 101010101001, 101010101001, 101010101001, 101010101001, 101010101001, 101010101001, 101010101001, 101010101001, 101010101001, 101010101001, 101010101001, 101010101001, 101010101001, 101010101001, 101010101001, 101010101001, 101010101001, 101010101001, 101010101001, 101010101001, 101010101001, 101010101001, 101010101001, 101010101001, 101010101001, 101010101001, 101010101001, 101010101001, 101010101001, 101010101001, 101010101001, 101010101001, 101010101001, 101010101001, 101010101001, 101010101001, 101010101001, 101010101001, 101010101001, 100110101001, 100110101001, 100110101001, 100110101001, 100110101001, 100110101001, 100110101001, 100110101001, 100110101001, 100110101001, 100110101001, 100110101001, 100110101001, 100110101001, 100110101001, 100110101001, 100110101001, 100110101001, 011110000111, 010001000100, 110111011101, 111111111111, 011101110111, 111111111111, 
111111111111, 011001100110, 111111111111, 011101100110, 110101000100, 111100000000, 111100000000, 111100000000, 111100000000, 111100000000, 111100010000, 111100100000, 111100100000, 111100110000, 111100110000, 111101000000, 111101010000, 111101010000, 111101100000, 111101100000, 111101110000, 111110000000, 111110000000, 111110010000, 111110010000, 111110100000, 111110110000, 111110110000, 111011000100, 110011001011, 110011001100, 110011001100, 110011001100, 110011001100, 110011001100, 110011001100, 110011001100, 110011001100, 110011001100, 110011001100, 110011001100, 110011001100, 110011001100, 110011001100, 110011001100, 110011001100, 110011001100, 110011001100, 110011001100, 110011001100, 110011001100, 110011001100, 110011001100, 110011001100, 110011001100, 110011001100, 110011001100, 110011001100, 110011001100, 110011001100, 110011001100, 110011001100, 110011001100, 110011001100, 110011001100, 110011001100, 110011001100, 110011001100, 110011001100, 110011001100, 110011001100, 110011001100, 110011001100, 110011001100, 110011001100, 110011001100, 110011001100, 110011001100, 110011001100, 110011001100, 110011001100, 110011001100, 110011001100, 110011001100, 110011001100, 110011001100, 110011001100, 110011001100, 110011001100, 110011001100, 110011001100, 011110110101, 011001100110, 111111111111, 100110011001, 111111111111, 
111111111111, 011001100110, 111111111111, 011000110011, 111100000000, 111100000000, 111100000000, 111100000000, 111100000000, 111100000000, 111100010000, 111100100000, 111100100000, 111100110000, 111100110000, 111101000000, 111101010000, 111101010000, 111101100000, 111101100000, 111101110000, 111110000000, 111110000000, 111110010000, 111110010000, 111110100000, 111110110000, 111110110000, 111011000100, 110011001011, 110011001100, 110011001100, 110011001100, 110011001100, 110011001100, 110011001100, 110011001100, 110011001100, 110011001100, 110011001100, 110011001100, 110011001100, 110011001100, 110011001100, 110011001100, 110011001100, 110011001100, 110011001100, 110011001100, 110011001100, 110011001100, 110011001100, 110011001100, 110011001100, 110011001100, 110011001100, 110011001100, 110011001100, 110011001100, 110011001100, 110011001100, 110011001100, 110011001100, 110011001100, 110011001100, 110011001100, 110011001100, 110011001100, 110011001100, 110011001100, 110011001100, 110011001100, 110011001100, 110011001100, 110011001100, 110011001100, 110011001100, 110011001100, 110011001100, 110011001100, 110011001100, 110011001100, 110011001100, 110011001100, 110011001100, 110011001100, 110011001100, 110011001100, 110011001100, 110011001100, 110011001100, 010111110001, 010001010011, 111111111111, 100110011001, 111111111111, 
111111111111, 011001100110, 110111011101, 011101000100, 111100000000, 111100000000, 111100000000, 111100000000, 111100000000, 111100000000, 111100010000, 111100100000, 111100100000, 111100110000, 111100110000, 111101000000, 111101010000, 111101010000, 111101100000, 111101100000, 111101110000, 111110000000, 111110000000, 111110010000, 111110010000, 111110100000, 111110110000, 111110110000, 111011000100, 110011001011, 110011001100, 110011001100, 110011001100, 110011001100, 110011001100, 110011001100, 110011001100, 110011001100, 110011001100, 110011001100, 110011001100, 110011001100, 110011001100, 110011001100, 110011001100, 110011001100, 110011001100, 110011001100, 110011001100, 110011001100, 110011001100, 110011001100, 110011001100, 110011001100, 110011001100, 110011001100, 110011001100, 110011001100, 110011001100, 110011001100, 110011001100, 110011001100, 110011001100, 110011001100, 110011001100, 110011001100, 110011001100, 110011001100, 110011001100, 110011001100, 110011001100, 110011001100, 110011001100, 110011001100, 110011001100, 110011001100, 110011001100, 110011001100, 110011001100, 110011001100, 110011001100, 110011001100, 110011001100, 110011001100, 110011001100, 110011001100, 110011001100, 110011001100, 110011001100, 110011001100, 110011001100, 010111110001, 010101100100, 111111111111, 100110011001, 111111111111, 
111111111111, 011001100110, 110111011101, 011101000100, 111100000000, 111100000000, 111100000000, 111100000000, 111100000000, 111100000000, 111100010000, 111100100000, 111100100000, 111100110000, 111100110000, 111101000000, 111101010000, 111101010000, 111101100000, 111101100000, 111101110000, 111110000000, 111110000000, 111110010000, 111110010000, 111110100000, 111110110000, 111110110000, 111011000100, 110011001011, 110011001100, 110011001100, 110011001100, 110011001100, 110011001100, 110011001100, 110011001100, 110011001100, 110011001100, 110011001100, 110011001100, 110011001100, 110011001100, 110011001100, 110011001100, 110011001100, 110011001100, 110011001100, 110011001100, 110011001100, 110011001100, 110011001100, 110011001100, 110011001100, 110011001100, 110011001100, 110011001100, 110011001100, 110011001100, 110011001100, 110011001100, 110011001100, 110011001100, 110011001100, 110011001100, 110011001100, 110011001100, 110011001100, 110011001100, 110011001100, 110011001100, 110011001100, 110011001100, 110011001100, 110011001100, 110011001100, 110011001100, 110011001100, 110011001100, 110011001100, 110011001100, 110011001100, 110011001100, 110011001100, 110011001100, 110011001100, 110011001100, 110011001100, 110011001100, 110011001100, 110011001100, 010111110001, 010001100100, 111111111111, 100110011001, 111111111111, 
111111111111, 011001100110, 111011011101, 011100110011, 111100000000, 111100000000, 111100000000, 111100000000, 111100000000, 111100000000, 111100010000, 111100100000, 111100100000, 111100110000, 111100110000, 111101000000, 111101010000, 111101010000, 111101100000, 111101100000, 111101110000, 111110000000, 111110000000, 111110010000, 111110010000, 111110100000, 111110110000, 111110110000, 111011000100, 110011001011, 110011001100, 110011001100, 110011001100, 110011001100, 110011001100, 110011001100, 110011001100, 110011001100, 110011001100, 110011001100, 110011001100, 110011001100, 110011001100, 110011001100, 110011001100, 110011001100, 110011001100, 110011001100, 110011001100, 110011001100, 110011001100, 110011001100, 110011001100, 110011001100, 110011001100, 110011001100, 110011001100, 110011001100, 110011001100, 110011001100, 110011001100, 110011001100, 110011001100, 110011001100, 110011001100, 110011001100, 110011001100, 110011001100, 110011001100, 110011001100, 110011001100, 110011001100, 110011001100, 110011001100, 110011001100, 110011001100, 110011001100, 110011001100, 110011001100, 110011001100, 110011001100, 110011001100, 110011001100, 110011001100, 110011001100, 110011001100, 110011001100, 110011001100, 110011001100, 110011001100, 110011001100, 011011110001, 010001100011, 111111111111, 100110011001, 111111111111, 
111111111111, 011001100110, 111111111111, 011101010101, 110000100010, 111100000000, 111100000000, 111100000000, 111100000000, 111100000000, 111100010000, 111100100000, 111100100000, 111100110000, 111100110000, 111101000000, 111101010000, 111101010000, 111101100000, 111101100000, 111101110000, 111110000000, 111110000000, 111110010000, 111110010000, 111110100000, 111110110000, 111110110000, 111011000100, 110011001011, 110011001100, 110011001100, 110011001100, 110011001100, 110011001100, 110011001100, 110011001100, 110011001100, 110011001100, 110011001100, 110011001100, 110011001100, 110011001100, 110011001100, 110011001100, 110011001100, 110011001100, 110011001100, 110011001100, 110011001100, 110011001100, 110011001100, 110011001100, 110011001100, 110011001100, 110011001100, 110011001100, 110011001100, 110011001100, 110011001100, 110011001100, 110011001100, 110011001100, 110011001100, 110011001100, 110011001100, 110011001100, 110011001100, 110011001100, 110011001100, 110011001100, 110011001100, 110011001100, 110011001100, 110011001100, 110011001100, 110011001100, 110011001100, 110011001100, 110011001100, 110011001100, 110011001100, 110011001100, 110011001100, 110011001100, 110011001100, 110011001100, 110011001100, 110011001100, 110011001100, 110011001100, 011010110011, 011001110110, 111111111111, 100110011001, 111111111111, 
111111111111, 011001100110, 111111111111, 101110111011, 011101010101, 101000010001, 101100010001, 101100010001, 101100010001, 101100100001, 101100100001, 101100100001, 101100110001, 101100110001, 101100110001, 101101000001, 101101000001, 101101010001, 101101010001, 101101010001, 101101100001, 101101100001, 101101100001, 101101110001, 101101110001, 101101110001, 101110000001, 101110000001, 101010000100, 100110000111, 100110001000, 100110011000, 100110011000, 100110011000, 100110011000, 100110011000, 100110011000, 100110011000, 100110011000, 100110011000, 100110011000, 100110011000, 100110011000, 100110011000, 100110011000, 100110011000, 100010011000, 100010011000, 100010011000, 100010011000, 100010011000, 100010011000, 100010011000, 100010011000, 100010011000, 100010011000, 100010011000, 100010011000, 100010011000, 100010011000, 100010011000, 100010011000, 100010011000, 100010011000, 100010011000, 100010011000, 100010011000, 100010011000, 100010011000, 100010011000, 100010011000, 100010011000, 100010011000, 100010011000, 100010011000, 100010011000, 100010011000, 100010011000, 100010011000, 100010011000, 100010011000, 100010011000, 100010011000, 100010011000, 100010011000, 100010011000, 100010011000, 100010011000, 100010011000, 100010011000, 011110000111, 011001110110, 110011001100, 111111111111, 100010001000, 111111111111, 
111111111111, 011101110111, 110111011101, 111111111111, 101110111011, 100110001000, 100110001000, 100110001000, 100110001000, 100110001000, 100110001000, 100110001000, 100110001000, 100110001000, 100110001000, 100110001000, 100110001000, 100110001000, 100110001000, 100110001000, 100110001000, 100110001000, 100110001000, 100110001000, 100110001000, 100110001000, 100110001000, 100110001000, 100110011000, 100110011000, 100110011000, 100110011000, 100110011000, 100110011000, 100110011000, 100110011000, 100110011000, 100110011000, 100110011000, 100110011000, 100110011000, 100110011000, 100110011000, 100110011000, 100110011000, 100110011000, 100110011000, 100110011000, 100110011000, 100110011000, 100110011000, 100110011000, 100110011000, 100110011000, 100110011000, 100110011000, 100110011000, 100110011000, 100010011000, 100010011000, 100010011000, 100010011000, 100010011000, 100010011000, 100010011000, 100010011000, 100010011000, 100010011000, 100010011000, 100010011000, 100010011000, 100010011000, 100010011000, 100010011000, 100010011000, 100010011000, 100010011000, 100010011000, 100010011000, 100010011000, 100010011000, 100010011000, 100010011000, 100010011000, 100010011000, 100010011000, 100010011000, 100010011000, 100010011000, 100010011000, 100010011000, 101110111011, 111111111111, 111111111111, 011101110111, 111111111111, 
111111111111, 110011001100, 011101110111, 110011001100, 111111111111, 110111011101, 110111011101, 110111011101, 110111011101, 110111011101, 110111011101, 110111011101, 110111011101, 110111011101, 110111011101, 110111011101, 110111011101, 110111011101, 110111011101, 110111011101, 110111011101, 110111011101, 110111011101, 110111011101, 110111011101, 110111011101, 110111011101, 110111011101, 110111011101, 110111011101, 110111011101, 110111011101, 110111011101, 110111011101, 110111011101, 110111011101, 110111011101, 110111011101, 110111011101, 110111011101, 110111011101, 110111011101, 110111011101, 110111011101, 110111011101, 110111011101, 110111011101, 110111011101, 110111011101, 110111011101, 110111011101, 110111011101, 110111011101, 110111011101, 110111011101, 110111011101, 110111011101, 110111011101, 110111011101, 110111011101, 110111011101, 110111011101, 110111011101, 110111011101, 110111011101, 110111011101, 110111011101, 110111011101, 110111011101, 110111011101, 110111011101, 110111011101, 110111011101, 110111011101, 110111011101, 110111011101, 110111011101, 110111011101, 110111011101, 110111011101, 110111011101, 110111011101, 110111011101, 110111011101, 110111011101, 110111011101, 110111011101, 110111011101, 110111011101, 110111011101, 111111111111, 111111111111, 110111011101, 100010001000, 101010101010, 111111111111, 
111111111111, 111111111111, 101010101010, 100010001000, 011101110111, 011101110111, 011101110111, 011101110111, 011101110111, 011101110111, 011101110111, 011101110111, 011101110111, 011101110111, 011101110111, 011101110111, 011101110111, 011101110111, 011101110111, 011101110111, 011101110111, 011101110111, 011101110111, 011101110111, 011101110111, 011101110111, 011101110111, 011101110111, 011101110111, 011101110111, 011101110111, 011101110111, 011101110111, 011101110111, 011101110111, 011101110111, 011101110111, 011101110111, 011101110111, 011101110111, 011101110111, 011101110111, 011101110111, 011101110111, 011101110111, 011101110111, 011101110111, 011101110111, 011101110111, 011101110111, 011101110111, 011101110111, 011101110111, 011101110111, 011101110111, 011101110111, 011101110111, 011101110111, 011101110111, 011101110111, 011101110111, 011101110111, 011101110111, 011101110111, 011101110111, 011101110111, 011101110111, 011101110111, 011101110111, 011101110111, 011101110111, 011101110111, 011101110111, 011101110111, 011101110111, 011101110111, 011101110111, 011101110111, 011101110111, 011101110111, 011101110111, 011101110111, 011101110111, 011101110111, 011101110111, 011101110111, 011101110111, 011101110111, 011101110111, 011101110111, 011101110111, 011101110111, 100010001000, 100110011001, 111111111111, 111111111111, 
111111111111, 111111111111, 111111111111, 111111111111, 111111111111, 111111111111, 111111111111, 111111111111, 111111111111, 111111111111, 111111111111, 111111111111, 111111111111, 111111111111, 111111111111, 111111111111, 111111111111, 111111111111, 111111111111, 111111111111, 111111111111, 111111111111, 111111111111, 111111111111, 111111111111, 111111111111, 111111111111, 111111111111, 111111111111, 111111111111, 111111111111, 111111111111, 111111111111, 111111111111, 111111111111, 111111111111, 111111111111, 111111111111, 111111111111, 111111111111, 111111111111, 111111111111, 111111111111, 111111111111, 111111111111, 111111111111, 111111111111, 111111111111, 111111111111, 111111111111, 111111111111, 111111111111, 111111111111, 111111111111, 111111111111, 111111111111, 111111111111, 111111111111, 111111111111, 111111111111, 111111111111, 111111111111, 111111111111, 111111111111, 111111111111, 111111111111, 111111111111, 111111111111, 111111111111, 111111111111, 111111111111, 111111111111, 111111111111, 111111111111, 111111111111, 111111111111, 111111111111, 111111111111, 111111111111, 111111111111, 111111111111, 111111111111, 111111111111, 111111111111, 111111111111, 111111111111, 111111111111, 111111111111, 111111111111, 111111111111, 111111111111, 111111111111, 111111111111, 111111111111, 111111111111, 111111111111;
