111111111111, 111111111111, 111111111111, 111111111111, 111111111111, 111111111111, 111111111111, 111111111111, 111111111111, 111111111111, 111111111111, 111111111111, 111111111111, 111111111111, 111111111111, 111111111111, 111111111111, 111111111111, 111111111111, 111111111111, 000000000000, 000000000000, 000000000000, 000000000000, 000000000000, 000000000000, 000000000000, 000000000000, 000000000000, 000000000000, 000000000000, 000000000000, 000000000000, 000000000000, 000000000000, 000000000000, 000000000000, 000000000000, 000000000000, 000000000000, 000000000000, 000000000000, 000000000000, 000000000000, 000000000000, 000000000000, 000000000000, 000000000000, 000000000000, 000000000000, 000000000000, 000000000000, 000000000000, 000000000000, 000000000000, 000000000000, 000000000000, 000000000000, 000000000000, 000000000000, 000000000000, 000000000000, 000000000000, 111111111111, 111111111111, 111111111111, 111111111111, 111111111111, 111111111111, 111111111111, 111111111111, 111111111111, 111111111111, 111111111111, 111111111111, 111111111111, 111111111111, 111111111111, 111111111111, 111111111111, 111111111111, 111111111111, 111111111111, 111111111111, 111111111111, 111111111111, 111111111111, 111111111111, 111111111111, 111111111111, 111111111111, 111111111111, 111111111111, 111111111111, 111111111111, 111111111111, 
111111111111, 111111111111, 111111111111, 101010101010, 100010001000, 011101110111, 011101110111, 011101110111, 011101110111, 011101110111, 011101110111, 011101110111, 011101110111, 011101110111, 011101110111, 011101110111, 011101110111, 011101110111, 011101110111, 011101110111, 011101110111, 011101110111, 011101110111, 011101110111, 011101110111, 011101110111, 011101110111, 011101110111, 011101110111, 011101110111, 011101110111, 011101110111, 011101110111, 011101110111, 011101110111, 011101110111, 011101110111, 011101110111, 011101110111, 011101110111, 011101110111, 011101110111, 011101110111, 011101110111, 011101110111, 011101110111, 011101110111, 011101110111, 011101110111, 011101110111, 011101110111, 011101110111, 011101110111, 011101110111, 011101110111, 011101110111, 011101110111, 011101110111, 011101110111, 011101110111, 011101110111, 011101110111, 011101110111, 011101110111, 011101110111, 011101110111, 011101110111, 011101110111, 011101110111, 011101110111, 011101110111, 011101110111, 011101110111, 011101110111, 011101110111, 011101110111, 011101110111, 011101110111, 011101110111, 011101110111, 011101110111, 011101110111, 011101110111, 011101110111, 011101110111, 011101110111, 011101110111, 011101110111, 011101110111, 011101110111, 011101110111, 011101110111, 100010001000, 110111011101, 111111111111, 111111111111, 
111111111111, 111111111111, 011101110111, 100110011001, 110011001100, 110111011101, 110111011101, 110111011101, 110111011101, 110111011101, 110111011101, 110111011101, 110111011101, 110111011101, 110111011101, 110111011101, 110111011101, 110111011101, 110111011101, 110111011101, 110111011101, 110111011101, 110111011101, 110111011101, 110111011101, 110111011101, 110111011101, 110111011101, 110111011101, 110111011101, 110111011101, 110111011101, 110111011101, 110111011101, 110111011101, 110111011101, 110111011101, 110111011101, 110111011101, 110111011101, 110111011101, 110111011101, 110111011101, 110111011101, 110111011101, 110111011101, 110111011101, 110111011101, 110111011101, 110111011101, 110111011101, 110111011101, 110111011101, 110111011101, 110111011101, 110111011101, 110111011101, 110111011101, 110111011101, 110111011101, 110111011101, 110111011101, 110111011101, 110111011101, 110111011101, 110111011101, 110111011101, 110111011101, 110111011101, 110111011101, 110111011101, 110111011101, 110111011101, 110111011101, 110111011101, 110111011101, 110111011101, 110111011101, 110111011101, 110111011101, 110111011101, 110111011101, 110111011101, 110111011101, 110111011101, 110111011101, 110111011101, 110111011101, 110111011101, 110111011101, 110111011101, 110111011101, 101110111011, 010101010101, 110111011101, 111111111111, 
111111111111, 110011001100, 101010101010, 111111111111, 111111111111, 100010001000, 010101010101, 010101010101, 010101010101, 010101010101, 010101010101, 010101010101, 010101010101, 010101010101, 010101010101, 010101010101, 010101010101, 010101010101, 010101010101, 010101010101, 010101010101, 010101010101, 010101010101, 010101010101, 010101010101, 010101010101, 010101010101, 010101010101, 010101010101, 010101010101, 010101010101, 010101010101, 010101010101, 010101010101, 010101010101, 010101010101, 010101010101, 010101010101, 010101010101, 010101010101, 010101010101, 010101010101, 010101010101, 010101010101, 010101010101, 010101010101, 010101010101, 010101010101, 010101010101, 010101010101, 010101010101, 010101010101, 010101010101, 010101010101, 010101010101, 010101010101, 010101010101, 010101010101, 010101010101, 010101010101, 010101010101, 010101010101, 010101010101, 010101010101, 010101010101, 010101010101, 010101010101, 010101010101, 010101010101, 010101010101, 010101010101, 010101010101, 010101010101, 010101010101, 010101010101, 010101010101, 010101010101, 010101010101, 010101010101, 010101010101, 010101010101, 010101010101, 010101010101, 010101010101, 010101010101, 010101010101, 010101010101, 010101010101, 010101010101, 010101010101, 100010001000, 111111111111, 111111111111, 110111011101, 011101110111, 111111111111, 
111111111111, 101110111011, 110011001100, 110111011101, 010101010101, 100100100010, 110000110011, 110000110011, 110000110011, 110000110011, 110000110011, 110001000011, 110001000011, 110001010011, 110001010011, 110001010011, 110001100011, 110001100011, 110001100011, 110001110011, 110001110011, 110001110011, 110010000011, 110010000011, 110010000011, 110010010011, 110010010011, 110010100011, 110010100011, 110010100011, 110010110011, 110010110011, 110010110011, 110011000011, 110011000011, 110011000011, 110011000011, 110011000011, 110011000011, 110011000011, 110011000011, 101111000011, 101111000011, 101111000011, 101111000011, 101111000011, 101111000011, 101111000011, 101111000011, 101010101001, 101010101001, 101010101001, 101010101001, 101010101001, 101010101001, 101010101001, 101010101001, 101010101001, 101010101001, 101010101001, 101010101001, 101010101001, 101010101001, 101010101001, 101010101001, 101010101001, 101010101001, 101010101001, 101010101001, 101010101001, 101010101001, 101010101001, 101010101001, 101010101001, 101010101001, 101010101001, 101010101001, 101010101001, 101010101001, 101010101001, 101010101001, 101010101001, 101010101001, 101010101001, 101010101001, 101010101001, 100110101001, 100110101001, 100110101001, 100110101001, 011110000111, 010001000100, 110111011101, 111111111111, 100010001000, 111111111111, 
111111111111, 101110111011, 110011001100, 100010001000, 101101010101, 111100000000, 111100000000, 111100000000, 111100000000, 111100000000, 111100010000, 111100010000, 111100100000, 111100110000, 111100110000, 111101000000, 111101000000, 111101010000, 111101100000, 111101100000, 111101110000, 111101110000, 111110000000, 111110010000, 111110010000, 111110100000, 111110100000, 111110110000, 111111000000, 111111000000, 111111010000, 111111010000, 111111100000, 111111110000, 111111110000, 111111110000, 111111110000, 111111110000, 111111110000, 111111110000, 111011110000, 111011110000, 111011110000, 111011110000, 111011110000, 110111110000, 110111110000, 110111110000, 110111110000, 110011001100, 110011001100, 110011001100, 110011001100, 110011001100, 110011001100, 110011001100, 110011001100, 110011001100, 110011001100, 110011001100, 110011001100, 110011001100, 110011001100, 110011001100, 110011001100, 110011001100, 110011001100, 110011001100, 110011001100, 110011001100, 110011001100, 110011001100, 110011001100, 110011001100, 110011001100, 110011001100, 110011001100, 110011001100, 110011001100, 110011001100, 110011001100, 110011001100, 110011001100, 110011001100, 110011001100, 110011001100, 110011001100, 110011001100, 110011001100, 110011001100, 110011001100, 011111000100, 011001100110, 111111111111, 100110011001, 111111111111, 
111111111111, 101110111011, 110011001100, 011101100110, 111000000000, 111100000000, 111100000000, 111100000000, 111100000000, 111100000000, 111100010000, 111100010000, 111100100000, 111100110000, 111100110000, 111101000000, 111101000000, 111101010000, 111101100000, 111101100000, 111101110000, 111101110000, 111110000000, 111110010000, 111110010000, 111110100000, 111110100000, 111110110000, 111111000000, 111111000000, 111111010000, 111111010000, 111111100000, 111111110000, 111111110000, 111111110000, 111111110000, 111111110000, 111111110000, 111111110000, 111011110000, 111011110000, 111011110000, 111011110000, 111011110000, 110111110000, 110111110000, 110111110000, 110111110000, 110011001100, 110011001100, 110011001100, 110011001100, 110011001100, 110011001100, 110011001100, 110011001100, 110011001100, 110011001100, 110011001100, 110011001100, 110011001100, 110011001100, 110011001100, 110011001100, 110011001100, 110011001100, 110011001100, 110011001100, 110011001100, 110011001100, 110011001100, 110011001100, 110011001100, 110011001100, 110011001100, 110011001100, 110011001100, 110011001100, 110011001100, 110011001100, 110011001100, 110011001100, 110011001100, 110011001100, 110011001100, 110011001100, 110011001100, 110011001100, 110011001100, 110011001100, 010111110001, 010001010011, 111111111111, 100110011001, 111111111111, 
111111111111, 101110111011, 101110111011, 100001100110, 111000000000, 111100000000, 111100000000, 111100000000, 111100000000, 111100000000, 111100010000, 111100010000, 111100100000, 111100110000, 111100110000, 111101000000, 111101000000, 111101010000, 111101100000, 111101100000, 111101110000, 111101110000, 111110000000, 111110010000, 111110010000, 111110100000, 111110100000, 111110110000, 111111000000, 111111000000, 111111010000, 111111010000, 111111100000, 111111110000, 111111110000, 111111110000, 111111110000, 111111110000, 111111110000, 111111110000, 111011110000, 111011110000, 111011110000, 111011110000, 111011110000, 110111110000, 110111110000, 110111110000, 110111110000, 110011001100, 110011001100, 110011001100, 110011001100, 110011001100, 110011001100, 110011001100, 110011001100, 110011001100, 110011001100, 110011001100, 110011001100, 110011001100, 110011001100, 110011001100, 110011001100, 110011001100, 110011001100, 110011001100, 110011001100, 110011001100, 110011001100, 110011001100, 110011001100, 110011001100, 110011001100, 110011001100, 110011001100, 110011001100, 110011001100, 110011001100, 110011001100, 110011001100, 110011001100, 110011001100, 110011001100, 110011001100, 110011001100, 110011001100, 110011001100, 110011001100, 110011001100, 010111110000, 010001100100, 111111111111, 100110011001, 111111111111, 
111111111111, 101110111011, 101110111011, 100001100110, 111000000000, 111100000000, 111100000000, 111100000000, 111100000000, 111100000000, 111100010000, 111100010000, 111100100000, 111100110000, 111100110000, 111101000000, 111101000000, 111101010000, 111101100000, 111101100000, 111101110000, 111101110000, 111110000000, 111110010000, 111110010000, 111110100000, 111110100000, 111110110000, 111111000000, 111111000000, 111111010000, 111111010000, 111111100000, 111111110000, 111111110000, 111111110000, 111111110000, 111111110000, 111111110000, 111111110000, 111011110000, 111011110000, 111011110000, 111011110000, 111011110000, 110111110000, 110111110000, 110111110000, 110111110000, 110011001100, 110011001100, 110011001100, 110011001100, 110011001100, 110011001100, 110011001100, 110011001100, 110011001100, 110011001100, 110011001100, 110011001100, 110011001100, 110011001100, 110011001100, 110011001100, 110011001100, 110011001100, 110011001100, 110011001100, 110011001100, 110011001100, 110011001100, 110011001100, 110011001100, 110011001100, 110011001100, 110011001100, 110011001100, 110011001100, 110011001100, 110011001100, 110011001100, 110011001100, 110011001100, 110011001100, 110011001100, 110011001100, 110011001100, 110011001100, 110011001100, 110011001100, 010111110000, 010001100100, 111111111111, 100110011001, 111111111111, 
111111111111, 101110111011, 110011001100, 011101100110, 111000010001, 111100000000, 111100000000, 111100000000, 111100000000, 111100000000, 111100010000, 111100010000, 111100100000, 111100110000, 111100110000, 111101000000, 111101000000, 111101010000, 111101100000, 111101100000, 111101110000, 111101110000, 111110000000, 111110010000, 111110010000, 111110100000, 111110100000, 111110110000, 111111000000, 111111000000, 111111010000, 111111010000, 111111100000, 111111110000, 111111110000, 111111110000, 111111110000, 111111110000, 111111110000, 111111110000, 111011110000, 111011110000, 111011110000, 111011110000, 111011110000, 110111110000, 110111110000, 110111110000, 110111110000, 110011001100, 110011001100, 110011001100, 110011001100, 110011001100, 110011001100, 110011001100, 110011001100, 110011001100, 110011001100, 110011001100, 110011001100, 110011001100, 110011001100, 110011001100, 110011001100, 110011001100, 110011001100, 110011001100, 110011001100, 110011001100, 110011001100, 110011001100, 110011001100, 110011001100, 110011001100, 110011001100, 110011001100, 110011001100, 110011001100, 110011001100, 110011001100, 110011001100, 110011001100, 110011001100, 110011001100, 110011001100, 110011001100, 110011001100, 110011001100, 110011001100, 110011001100, 010111110001, 010001010100, 111111111111, 100110011001, 111111111111, 
111111111111, 101110111011, 110011001100, 100010001000, 101001000100, 111100000000, 111100000000, 111100000000, 111100000000, 111100000000, 111100010000, 111100010000, 111100100000, 111100110000, 111100110000, 111101000000, 111101000000, 111101010000, 111101100000, 111101100000, 111101110000, 111101110000, 111110000000, 111110010000, 111110010000, 111110100000, 111110100000, 111110110000, 111111000000, 111111000000, 111111010000, 111111010000, 111111100000, 111111110000, 111111110000, 111111110000, 111111110000, 111111110000, 111111110000, 111111110000, 111011110000, 111011110000, 111011110000, 111011110000, 111011110000, 110111110000, 110111110000, 110111110000, 110111110000, 110011001100, 110011001100, 110011001100, 110011001100, 110011001100, 110011001100, 110011001100, 110011001100, 110011001100, 110011001100, 110011001100, 110011001100, 110011001100, 110011001100, 110011001100, 110011001100, 110011001100, 110011001100, 110011001100, 110011001100, 110011001100, 110011001100, 110011001100, 110011001100, 110011001100, 110011001100, 110011001100, 110011001100, 110011001100, 110011001100, 110011001100, 110011001100, 110011001100, 110011001100, 110011001100, 110011001100, 110011001100, 110011001100, 110011001100, 110011001100, 110011001100, 110011001100, 011010110011, 011101110111, 111111111111, 100110011001, 111111111111, 
111111111111, 101110111011, 110011001100, 110111011101, 100001110111, 100000010001, 101000010001, 101000010001, 101000100001, 101000100001, 101000100001, 101000100001, 101000110001, 101000110001, 101000110001, 101001000001, 101001000001, 101001000001, 101001010001, 101001010001, 101001010001, 101001100001, 101001100001, 101001100001, 101001110001, 101001110001, 101001110001, 101001110001, 101010000001, 101010000001, 101010000001, 101010010001, 101010010001, 101010010001, 101010100001, 101010100001, 101010100001, 101010100001, 100110100001, 100110100001, 100110100001, 100110100001, 100110100001, 100110100001, 100110100001, 100110100001, 100110100001, 100010100001, 100010100001, 100010000111, 100010000111, 100010000111, 100010000111, 100010000111, 100010000111, 100010000111, 100010000111, 100010000111, 100010000111, 100010000111, 100010000111, 100010000111, 100010000111, 100010000111, 100010000111, 100010000111, 100010000111, 100010000111, 100010000111, 100010000111, 100010000111, 100010000111, 011110000111, 011110000111, 011110000111, 011110000111, 011110000111, 011110000111, 011110000111, 011110000111, 011110000111, 011110000111, 011110000111, 011110000111, 011110000111, 011110000111, 011110000111, 011110000111, 011110000111, 011110000111, 011001110110, 011001110110, 110111011101, 111111111111, 100110011001, 111111111111, 
111111111111, 110011001100, 101110111011, 111111111111, 110111011101, 101010101010, 101010011001, 101010011001, 101010011001, 101010011001, 101010011001, 101010011001, 101010011001, 101010011001, 101010011001, 101010011001, 101010011001, 101010011001, 101010011001, 101010011001, 101010011001, 101010011001, 101010011001, 101010011001, 101010011001, 101010011001, 101010011001, 101010011001, 101010011001, 101010011001, 101010011001, 101010011001, 101010011001, 101010101001, 101010101001, 101010101001, 101010101001, 101010101001, 101010101001, 101010101001, 100110101001, 100110101001, 100110101001, 100110101001, 100110101001, 100110101001, 100110101001, 100110101001, 100110101001, 100110101001, 100110101001, 100110101001, 100110101001, 100110101001, 100110101001, 100110101001, 100110101001, 100110101001, 100110101001, 100110101001, 100110101001, 100110101001, 100110101001, 100110101001, 100110101001, 100110101001, 100110101001, 100110101001, 100110101001, 100110101001, 100110101001, 100110101001, 100110101001, 100110101001, 100110101001, 100110101001, 100110101001, 100110101001, 100110101001, 100110101001, 100110101001, 100110101001, 100110101001, 100110101001, 100110101001, 100110101001, 100110101001, 100110101001, 100110101001, 100110011001, 101010101001, 110011001100, 111111111111, 111111111111, 100010001000, 111111111111, 
111111111111, 111111111111, 100010001000, 101010101010, 110111011101, 111111111111, 110111011101, 110111011101, 110111011101, 110111011101, 110111011101, 110111011101, 110111011101, 110111011101, 110111011101, 110111011101, 110111011101, 110111011101, 110111011101, 110111011101, 110111011101, 110111011101, 110111011101, 110111011101, 110111011101, 110111011101, 110111011101, 110111011101, 110111011101, 110111011101, 110111011101, 110111011101, 110111011101, 110111011101, 110111011101, 110111011101, 110111011101, 110111011101, 110111011101, 110111011101, 110111011101, 110111011101, 110111011101, 110111011101, 110111011101, 110111011101, 110111011101, 110111011101, 110111011101, 110111011101, 110111011101, 110111011101, 110111011101, 110111011101, 110111011101, 110111011101, 110111011101, 110111011101, 110111011101, 110111011101, 110111011101, 110111011101, 110111011101, 110111011101, 110111011101, 110111011101, 110111011101, 110111011101, 110111011101, 110111011101, 110111011101, 110111011101, 110111011101, 110111011101, 110111011101, 110111011101, 110111011101, 110111011101, 110111011101, 110111011101, 110111011101, 110111011101, 110111011101, 110111011101, 110111011101, 110111011101, 110111011101, 110111011101, 110111011101, 110111011101, 111111111111, 111111111111, 110111011101, 011101110111, 101110111011, 111111111111, 
111111111111, 111111111111, 110011001100, 100010001000, 011001100110, 011001100110, 011001100110, 011001100110, 011001100110, 011001100110, 011001100110, 011001100110, 011001100110, 011001100110, 011001100110, 011001100110, 011001100110, 011001100110, 011001100110, 011001100110, 011001100110, 011001100110, 011001100110, 011001100110, 011001100110, 011001100110, 011001100110, 011001100110, 011001100110, 011001100110, 011001100110, 011001100110, 011001100110, 011001100110, 011001100110, 011001100110, 011001100110, 011001100110, 011001100110, 011001100110, 011001100110, 011001100110, 011001100110, 011001100110, 011001100110, 011001100110, 011001100110, 011001100110, 011001100110, 011001100110, 011001100110, 011001100110, 011001100110, 011001100110, 011001100110, 011001100110, 011001100110, 011001100110, 011001100110, 011001100110, 011001100110, 011001100110, 011001100110, 011001100110, 011001100110, 011001100110, 011001100110, 011001100110, 011001100110, 011001100110, 011001100110, 011001100110, 011001100110, 011001100110, 011001100110, 011001100110, 011001100110, 011001100110, 011001100110, 011001100110, 011001100110, 011001100110, 011001100110, 011001100110, 011001100110, 011001100110, 011001100110, 011001100110, 011001100110, 011001100110, 011001100110, 011001100110, 011101110111, 101010101010, 111111111111, 111111111111, 
111111111111, 111111111111, 111111111111, 111111111111, 111111111111, 111111111111, 111111111111, 111111111111, 111111111111, 111111111111, 111111111111, 111111111111, 111111111111, 111111111111, 111111111111, 111111111111, 111111111111, 111111111111, 111111111111, 111111111111, 111111111111, 111111111111, 111111111111, 111111111111, 111111111111, 111111111111, 111111111111, 111111111111, 111111111111, 111111111111, 111111111111, 111111111111, 111111111111, 111111111111, 111111111111, 111111111111, 111111111111, 111111111111, 111111111111, 111111111111, 111111111111, 111111111111, 111111111111, 111111111111, 111111111111, 111111111111, 111111111111, 111111111111, 111111111111, 111111111111, 111111111111, 111111111111, 111111111111, 111111111111, 111111111111, 111111111111, 111111111111, 111111111111, 111111111111, 111111111111, 111111111111, 111111111111, 111111111111, 111111111111, 111111111111, 111111111111, 111111111111, 111111111111, 111111111111, 111111111111, 111111111111, 111111111111, 111111111111, 111111111111, 111111111111, 111111111111, 111111111111, 111111111111, 111111111111, 111111111111, 111111111111, 111111111111, 111111111111, 111111111111, 111111111111, 111111111111, 111111111111, 111111111111, 111111111111, 111111111111, 111111111111, 111111111111, 111111111111, 111111111111, 111111111111, 111111111111;
