111111111111, 111111111111, 111111111111, 111111111111, 111111111111, 111111111111, 111111111111, 111111111111, 111111111111, 111111111111, 111111111111, 111111111111, 111111111111, 111111111111, 111111111111, 111111111111, 111111111111, 111111111111, 111111111111, 111111111111, 000000000000, 000000000000, 000000000000, 000000000000, 000000000000, 000000000000, 000000000000, 000000000000, 000000000000, 000000000000, 000000000000, 000000000000, 000000000000, 000000000000, 000000000000, 000000000000, 000000000000, 000000000000, 000000000000, 000000000000, 000000000000, 000000000000, 000000000000, 000000000000, 000000000000, 000000000000, 000000000000, 000000000000, 000000000000, 000000000000, 000000000000, 000000000000, 000000000000, 000000000000, 000000000000, 000000000000, 000000000000, 000000000000, 000000000000, 000000000000, 000000000000, 000000000000, 000000000000, 111111111111, 111111111111, 111111111111, 111111111111, 111111111111, 111111111111, 111111111111, 111111111111, 111111111111, 111111111111, 111111111111, 111111111111, 111111111111, 111111111111, 111111111111, 111111111111, 111111111111, 111111111111, 111111111111, 111111111111, 111111111111, 111111111111, 111111111111, 111111111111, 111111111111, 111111111111, 111111111111, 111111111111, 111111111111, 111111111111, 111111111111, 111111111111, 111111111111, 
111111111111, 111111111111, 110011001100, 011101110111, 010101010101, 010101010101, 010101010101, 010101010101, 010101010101, 010101010101, 010101010101, 010101010101, 010101010101, 010101010101, 010101010101, 010101010101, 010101010101, 010101010101, 010101010101, 010101010101, 010101010101, 010101010101, 010101010101, 010101010101, 010101010101, 010101010101, 010101010101, 010101010101, 010101010101, 010101010101, 010101010101, 010101010101, 010101010101, 010101010101, 010101010101, 010101010101, 010101010101, 010101010101, 010101010101, 010101010101, 010101010101, 010101010101, 010101010101, 010101010101, 010101010101, 010101010101, 010101010101, 010101010101, 010101010101, 010101010101, 010101010101, 010101010101, 010101010101, 010101010101, 010101010101, 010101010101, 010101010101, 010101010101, 010101010101, 010101010101, 010101010101, 010101010101, 010101010101, 010101010101, 010101010101, 010101010101, 010101010101, 010101010101, 010101010101, 010101010101, 010101010101, 010101010101, 010101010101, 010101010101, 010101010101, 010101010101, 010101010101, 010101010101, 010101010101, 010101010101, 010101010101, 010101010101, 010101010101, 010101010101, 010101010101, 010101010101, 010101010101, 010101010101, 011001100110, 101110111011, 111111111111, 111111111111, 111111111111, 111111111111, 111111111111, 111111111111, 
111111111111, 110111011101, 010101010101, 101110111011, 110111011101, 110111011101, 110111011101, 110111011101, 110111011101, 110111011101, 110111011101, 110111011101, 110111011101, 110111011101, 110111011101, 110111011101, 110111011101, 110111011101, 110111011101, 110111011101, 110111011101, 110111011101, 110111011101, 110111011101, 110111011101, 110111011101, 110111011101, 110111011101, 110111011101, 110111011101, 110111011101, 110111011101, 110111011101, 110111011101, 110111011101, 110111011101, 110111011101, 110111011101, 110111011101, 110111011101, 110111011101, 110111011101, 110111011101, 110111011101, 110111011101, 110111011101, 110111011101, 110111011101, 110111011101, 110111011101, 110111011101, 110111011101, 110111011101, 110111011101, 110111011101, 110111011101, 110111011101, 110111011101, 110111011101, 110111011101, 110111011101, 110111011101, 110111011101, 110111011101, 110111011101, 110111011101, 110111011101, 110111011101, 110111011101, 110111011101, 110111011101, 110111011101, 110111011101, 110111011101, 110111011101, 110111011101, 110111011101, 110111011101, 110111011101, 110111011101, 110111011101, 110111011101, 110111011101, 110111011101, 110111011101, 110111011101, 110111011101, 110111011101, 110011001100, 011001100110, 101010101010, 111111111111, 111111111111, 111111111111, 111111111111, 111111111111, 
111111111111, 100010001000, 110011001100, 111111111111, 101010101010, 011101110111, 011001100110, 011001100110, 011001100110, 011001100110, 011001100110, 011001100110, 011001100110, 011001100110, 011001100110, 011001100110, 011001100110, 011001100110, 011001100110, 011001100110, 011001100110, 011001100110, 011001100110, 011001100110, 011001100110, 011001100110, 011001100110, 011001100110, 011001100110, 011001100110, 011001100110, 011001100110, 011001100110, 011001100110, 011001100110, 011001100110, 011001100110, 011001100110, 011001100110, 011001100110, 011001100110, 011001100110, 011001100110, 011001100110, 011001100110, 011001100110, 011001100110, 011001100110, 011001100110, 011001100110, 011001100110, 011001100110, 011001100110, 011001100110, 011001100110, 011001100110, 011001100110, 011001100110, 011001100110, 011001100110, 011001100110, 011001100110, 011001100110, 011001100110, 011001100110, 011001100110, 011001100110, 011001100110, 011001100110, 011001100110, 011001100110, 011001100110, 011001100110, 011001100110, 011001100110, 011001100110, 011001100110, 011001100110, 011001100110, 011001100110, 011001100110, 011001100110, 011001100110, 011001100110, 011001100110, 011001100110, 011101110111, 101110111011, 111111111111, 111111111111, 010101010101, 111111111111, 111111111111, 111111111111, 111111111111, 111111111111, 
111111111111, 011001100110, 111111111111, 101010011001, 011101000100, 101001110111, 101010101010, 101010101010, 101010101010, 101010101010, 101010101010, 101010101010, 101010101010, 101010101010, 101010101010, 101010101010, 101010101010, 101010101010, 101010101010, 101010101010, 101010101010, 101010101010, 101010101010, 101010101010, 101010101010, 101010101010, 101010101010, 101010101010, 101010101010, 101010101010, 101010101010, 101010101010, 101010101010, 101010101010, 101010101010, 101010101010, 101010101010, 101010101010, 101010101010, 101010101010, 101010101010, 101010101010, 101010101010, 101010101010, 101010101010, 101010101010, 101010101010, 101010101010, 101010101010, 101010101010, 101010101010, 101010101010, 101010101010, 101010101010, 101010101010, 101010101010, 101010101010, 101010101010, 101010101010, 101010101010, 101010101010, 101010101010, 101010101010, 101010101010, 101010101010, 101010101010, 101010101010, 101010101010, 101010101010, 101010101010, 101010101010, 101010101010, 101010101010, 101010101010, 101010101010, 101010101010, 101010101010, 101010101010, 101010101010, 101010101010, 101010101010, 101010101010, 101010101010, 101010101010, 101010101010, 101010101001, 100110011001, 010101100101, 101010101010, 111111111111, 011001100110, 111111111111, 111111111111, 111111111111, 111111111111, 111111111111, 
111111111111, 011001100110, 110111011101, 100001010101, 110101000100, 110010011001, 110011001100, 110011001100, 110011001100, 110011001100, 110011001100, 110011001100, 110011001100, 110011001100, 110011001100, 110011001100, 110011001100, 110011001100, 110011001100, 110011001100, 110011001100, 110011001100, 110011001100, 110011001100, 110011001100, 110011001100, 110011001100, 110011001100, 110011001100, 110011001100, 110011001100, 110011001100, 110011001100, 110011001100, 110011001100, 110011001100, 110011001100, 110011001100, 110011001100, 110011001100, 110011001100, 110011001100, 110011001100, 110011001100, 110011001100, 110011001100, 110011001100, 110011001100, 110011001100, 110011001100, 110011001100, 110011001100, 110011001100, 110011001100, 110011001100, 110011001100, 110011001100, 110011001100, 110011001100, 110011001100, 110011001100, 110011001100, 110011001100, 110011001100, 110011001100, 110011001100, 110011001100, 110011001100, 110011001100, 110011001100, 110011001100, 110011001100, 110011001100, 110011001100, 110011001100, 110011001100, 110011001100, 110011001100, 110011001100, 110011001100, 110011001100, 110011001100, 110011001100, 110011001100, 110011001100, 110011001100, 110011001100, 100011000110, 011010000101, 111111111111, 011101110111, 111111111111, 111111111111, 111111111111, 111111111111, 111111111111, 
111111111111, 011001100110, 110011001100, 100000110011, 111100100010, 110010011001, 110011001100, 110011001100, 110011001100, 110011001100, 110011001100, 110011001100, 110011001100, 110011001100, 110011001100, 110011001100, 110011001100, 110011001100, 110011001100, 110011001100, 110011001100, 110011001100, 110011001100, 110011001100, 110011001100, 110011001100, 110011001100, 110011001100, 110011001100, 110011001100, 110011001100, 110011001100, 110011001100, 110011001100, 110011001100, 110011001100, 110011001100, 110011001100, 110011001100, 110011001100, 110011001100, 110011001100, 110011001100, 110011001100, 110011001100, 110011001100, 110011001100, 110011001100, 110011001100, 110011001100, 110011001100, 110011001100, 110011001100, 110011001100, 110011001100, 110011001100, 110011001100, 110011001100, 110011001100, 110011001100, 110011001100, 110011001100, 110011001100, 110011001100, 110011001100, 110011001100, 110011001100, 110011001100, 110011001100, 110011001100, 110011001100, 110011001100, 110011001100, 110011001100, 110011001100, 110011001100, 110011001100, 110011001100, 110011001100, 110011001100, 110011001100, 110011001100, 110011001100, 110011001100, 110011001100, 110011001100, 110011001100, 011111100100, 010010000010, 110111011101, 011101110111, 111111111111, 111111111111, 111111111111, 111111111111, 111111111111, 
111111111111, 011001100110, 110011001100, 100100110011, 111100100010, 110010011001, 110011001100, 110011001100, 110011001100, 110011001100, 110011001100, 110011001100, 110011001100, 110011001100, 110011001100, 110011001100, 110011001100, 110011001100, 110011001100, 110011001100, 110011001100, 110011001100, 110011001100, 110011001100, 110011001100, 110011001100, 110011001100, 110011001100, 110011001100, 110011001100, 110011001100, 110011001100, 110011001100, 110011001100, 110011001100, 110011001100, 110011001100, 110011001100, 110011001100, 110011001100, 110011001100, 110011001100, 110011001100, 110011001100, 110011001100, 110011001100, 110011001100, 110011001100, 110011001100, 110011001100, 110011001100, 110011001100, 110011001100, 110011001100, 110011001100, 110011001100, 110011001100, 110011001100, 110011001100, 110011001100, 110011001100, 110011001100, 110011001100, 110011001100, 110011001100, 110011001100, 110011001100, 110011001100, 110011001100, 110011001100, 110011001100, 110011001100, 110011001100, 110011001100, 110011001100, 110011001100, 110011001100, 110011001100, 110011001100, 110011001100, 110011001100, 110011001100, 110011001100, 110011001100, 110011001100, 110011001100, 110011001100, 011111100100, 010110010011, 110111011101, 011101110111, 111111111111, 111111111111, 111111111111, 111111111111, 111111111111, 
111111111111, 011001100110, 110011001100, 100100110011, 111100100010, 110010011001, 110011001100, 110011001100, 110011001100, 110011001100, 110011001100, 110011001100, 110011001100, 110011001100, 110011001100, 110011001100, 110011001100, 110011001100, 110011001100, 110011001100, 110011001100, 110011001100, 110011001100, 110011001100, 110011001100, 110011001100, 110011001100, 110011001100, 110011001100, 110011001100, 110011001100, 110011001100, 110011001100, 110011001100, 110011001100, 110011001100, 110011001100, 110011001100, 110011001100, 110011001100, 110011001100, 110011001100, 110011001100, 110011001100, 110011001100, 110011001100, 110011001100, 110011001100, 110011001100, 110011001100, 110011001100, 110011001100, 110011001100, 110011001100, 110011001100, 110011001100, 110011001100, 110011001100, 110011001100, 110011001100, 110011001100, 110011001100, 110011001100, 110011001100, 110011001100, 110011001100, 110011001100, 110011001100, 110011001100, 110011001100, 110011001100, 110011001100, 110011001100, 110011001100, 110011001100, 110011001100, 110011001100, 110011001100, 110011001100, 110011001100, 110011001100, 110011001100, 110011001100, 110011001100, 110011001100, 110011001100, 110011001100, 011111100100, 010010000011, 110111011101, 011101110111, 111111111111, 111111111111, 111111111111, 111111111111, 111111111111, 
111111111111, 011001100110, 110111011101, 100000110011, 111000110011, 110010011001, 110011001100, 110011001100, 110011001100, 110011001100, 110011001100, 110011001100, 110011001100, 110011001100, 110011001100, 110011001100, 110011001100, 110011001100, 110011001100, 110011001100, 110011001100, 110011001100, 110011001100, 110011001100, 110011001100, 110011001100, 110011001100, 110011001100, 110011001100, 110011001100, 110011001100, 110011001100, 110011001100, 110011001100, 110011001100, 110011001100, 110011001100, 110011001100, 110011001100, 110011001100, 110011001100, 110011001100, 110011001100, 110011001100, 110011001100, 110011001100, 110011001100, 110011001100, 110011001100, 110011001100, 110011001100, 110011001100, 110011001100, 110011001100, 110011001100, 110011001100, 110011001100, 110011001100, 110011001100, 110011001100, 110011001100, 110011001100, 110011001100, 110011001100, 110011001100, 110011001100, 110011001100, 110011001100, 110011001100, 110011001100, 110011001100, 110011001100, 110011001100, 110011001100, 110011001100, 110011001100, 110011001100, 110011001100, 110011001100, 110011001100, 110011001100, 110011001100, 110011001100, 110011001100, 110011001100, 110011001100, 110011001100, 100011100101, 010010000011, 110111011101, 011101110111, 111111111111, 111111111111, 111111111111, 111111111111, 111111111111, 
111111111111, 011001100110, 111111111111, 100001100110, 101101010101, 110010011001, 110011001100, 110011001100, 110011001100, 110011001100, 110011001100, 110011001100, 110011001100, 110011001100, 110011001100, 110011001100, 110011001100, 110011001100, 110011001100, 110011001100, 110011001100, 110011001100, 110011001100, 110011001100, 110011001100, 110011001100, 110011001100, 110011001100, 110011001100, 110011001100, 110011001100, 110011001100, 110011001100, 110011001100, 110011001100, 110011001100, 110011001100, 110011001100, 110011001100, 110011001100, 110011001100, 110011001100, 110011001100, 110011001100, 110011001100, 110011001100, 110011001100, 110011001100, 110011001100, 110011001100, 110011001100, 110011001100, 110011001100, 110011001100, 110011001100, 110011001100, 110011001100, 110011001100, 110011001100, 110011001100, 110011001100, 110011001100, 110011001100, 110011001100, 110011001100, 110011001100, 110011001100, 110011001100, 110011001100, 110011001100, 110011001100, 110011001100, 110011001100, 110011001100, 110011001100, 110011001100, 110011001100, 110011001100, 110011001100, 110011001100, 110011001100, 110011001100, 110011001100, 110011001100, 110011001100, 110011001100, 110011001100, 100010100111, 011110000111, 111111111111, 011101110111, 111111111111, 111111111111, 111111111111, 111111111111, 111111111111, 
111111111111, 011001100110, 111111111111, 110011001100, 011001010101, 010100110011, 011001010101, 011001010101, 011001010101, 011001010101, 011001010101, 011001010101, 011001010101, 011001010101, 011001010101, 011001010101, 011001010101, 011001010101, 011001010101, 011001010101, 011001010101, 011001010101, 011001100101, 011001100101, 011001100101, 011001100101, 011001100101, 011001100101, 011001100101, 011001100101, 011001100101, 011001100101, 011001100101, 011001100101, 011001100101, 011001100101, 011001100101, 011001100101, 011001100101, 011001100101, 011001100101, 011001100101, 011001100101, 011001100101, 011001100101, 011001100101, 011001100101, 011001100101, 011001100101, 011001100101, 011001100101, 011001100101, 011001100101, 011001100101, 011001100101, 011001100101, 011001100101, 011001100101, 011001100101, 011001100101, 011001100101, 011001100101, 011001100101, 011001100101, 011001100101, 011001100101, 011001100101, 011001100101, 011001100101, 010101100101, 010101100101, 010101100101, 010101100101, 010101100101, 010101100101, 010101100101, 010101100101, 010101100101, 010101100101, 010101100101, 010101100101, 010101100101, 010101100101, 010101100101, 010101100101, 010101100100, 010001010100, 010101100101, 110011001100, 111111111111, 011001100110, 111111111111, 111111111111, 111111111111, 111111111111, 111111111111, 
111111111111, 100010001000, 110011001100, 111111111111, 111111111111, 110011001100, 101110111011, 101110111011, 101110111011, 101110111011, 101110111011, 101110111011, 101110111011, 101110111011, 101110111011, 101110111011, 101110111011, 101110111011, 101110111011, 101110111011, 101110111011, 101110111011, 101110111011, 101110111011, 101110111011, 101110111011, 101110111011, 101110111011, 101110111011, 101110111011, 101110111011, 101110111011, 101110111011, 101110111011, 101110111011, 101110111011, 101110111011, 101110111011, 101110111011, 101110111011, 101110111011, 101110111011, 101110111011, 101110111011, 101110111011, 101110111011, 101110111011, 101110111011, 101110111011, 101110111011, 101110111011, 101110111011, 101110111011, 101110111011, 101110111011, 101110111011, 101110111011, 101110111011, 101110111011, 101110111011, 101110111011, 101110111011, 101110111011, 101110111011, 101110111011, 101110111011, 101110111011, 101110111011, 101110111011, 101110111011, 101110111011, 101110111011, 101110111011, 101110111011, 101110111011, 101110111011, 101110111011, 101110111011, 101110111011, 101110111011, 101110111011, 101110111011, 101110111011, 101110111011, 101110111011, 101110111011, 110011011100, 111111111111, 111111111111, 111111111111, 010101010101, 111111111111, 111111111111, 111111111111, 111111111111, 111111111111, 
111111111111, 110111011101, 010101010101, 101110111011, 110111011101, 110111011101, 110111011101, 110111011101, 110111011101, 110111011101, 110111011101, 110111011101, 110111011101, 110111011101, 110111011101, 110111011101, 110111011101, 110111011101, 110111011101, 110111011101, 110111011101, 110111011101, 110111011101, 110111011101, 110111011101, 110111011101, 110111011101, 110111011101, 110111011101, 110111011101, 110111011101, 110111011101, 110111011101, 110111011101, 110111011101, 110111011101, 110111011101, 110111011101, 110111011101, 110111011101, 110111011101, 110111011101, 110111011101, 110111011101, 110111011101, 110111011101, 110111011101, 110111011101, 110111011101, 110111011101, 110111011101, 110111011101, 110111011101, 110111011101, 110111011101, 110111011101, 110111011101, 110111011101, 110111011101, 110111011101, 110111011101, 110111011101, 110111011101, 110111011101, 110111011101, 110111011101, 110111011101, 110111011101, 110111011101, 110111011101, 110111011101, 110111011101, 110111011101, 110111011101, 110111011101, 110111011101, 110111011101, 110111011101, 110111011101, 110111011101, 110111011101, 110111011101, 110111011101, 110111011101, 110111011101, 110111011101, 110111011101, 110111011101, 110011001100, 011001100110, 101110111011, 111111111111, 111111111111, 111111111111, 111111111111, 111111111111, 
111111111111, 111111111111, 110111011101, 100010001000, 011001100110, 011001100110, 011001100110, 011001100110, 011001100110, 011001100110, 011001100110, 011001100110, 011001100110, 011001100110, 011001100110, 011001100110, 011001100110, 011001100110, 011001100110, 011001100110, 011001100110, 011001100110, 011001100110, 011001100110, 011001100110, 011001100110, 011001100110, 011001100110, 011001100110, 011001100110, 011001100110, 011001100110, 011001100110, 011001100110, 011001100110, 011001100110, 011001100110, 011001100110, 011001100110, 011001100110, 011001100110, 011001100110, 011001100110, 011001100110, 011001100110, 011001100110, 011001100110, 011001100110, 011001100110, 011001100110, 011001100110, 011001100110, 011001100110, 011001100110, 011001100110, 011001100110, 011001100110, 011001100110, 011001100110, 011001100110, 011001100110, 011001100110, 011001100110, 011001100110, 011001100110, 011001100110, 011001100110, 011001100110, 011001100110, 011001100110, 011001100110, 011001100110, 011001100110, 011001100110, 011001100110, 011001100110, 011001100110, 011001100110, 011001100110, 011001100110, 011001100110, 011001100110, 011001100110, 011001100110, 011001100110, 011001100110, 011001100110, 011001100110, 011101110111, 101110111011, 111111111111, 111111111111, 111111111111, 111111111111, 111111111111, 111111111111, 
111111111111, 111111111111, 111111111111, 111111111111, 111111111111, 111111111111, 111111111111, 111111111111, 111111111111, 111111111111, 111111111111, 111111111111, 111111111111, 111111111111, 111111111111, 111111111111, 111111111111, 111111111111, 111111111111, 111111111111, 111111111111, 111111111111, 111111111111, 111111111111, 111111111111, 111111111111, 111111111111, 111111111111, 111111111111, 111111111111, 111111111111, 111111111111, 111111111111, 111111111111, 111111111111, 111111111111, 111111111111, 111111111111, 111111111111, 111111111111, 111111111111, 111111111111, 111111111111, 111111111111, 111111111111, 111111111111, 111111111111, 111111111111, 111111111111, 111111111111, 111111111111, 111111111111, 111111111111, 111111111111, 111111111111, 111111111111, 111111111111, 111111111111, 111111111111, 111111111111, 111111111111, 111111111111, 111111111111, 111111111111, 111111111111, 111111111111, 111111111111, 111111111111, 111111111111, 111111111111, 111111111111, 111111111111, 111111111111, 111111111111, 111111111111, 111111111111, 111111111111, 111111111111, 111111111111, 111111111111, 111111111111, 111111111111, 111111111111, 111111111111, 111111111111, 111111111111, 111111111111, 111111111111, 111111111111, 111111111111, 111111111111, 111111111111, 111111111111, 111111111111, 111111111111, 111111111111;
